an ao	万劫难逃 五毒邪元爪 坐马单桥 夜叉探爪 截拳道 拳道 独臂单桥 独臂单桥 神通弹道 蜂毒贯脑 螺旋绞 跆拳道 银战袍 鹰旋刀
ian a	三分天下 千军万马惊天下 君临天下 惊天杀 拳倾天下 独霸天下 鹰临天下
ing ian a	千军万马惊天下 惊天杀 拳倾天下
an ing ian a	拳倾天下
ang an	七伤拳 七伤拳 不灭凤凰断 北斗冥王拳 天霜拳 密宗金刚拳 幻影破阳拳 拳仪江山 指点江山 海量汪涵 火龙双转 灭绝王拳 狂狼斩 穿越光环 虎啸皇拳 虎豹双拳 西洋拳 身光闪 金刚钻 金刚钻 阴风烈阳拳 青城金刚拳
i ang an	七伤拳 七伤拳 拳仪江山 西洋拳
an i ang an	拳仪江山
ian i	一泻千里 五岳毁天地 分裂天地 剑器 天击 天极 妖乱天地 拒人千里 拳为天地 断脉剑气 气游天地 气游天地 焦土千里 白马献蹄 虎千击 轰天击 轰天殛 雷动天地 飞马献蹄 飞鸿敛翼 麻鹰敛翼 龙游天地 龙跨千里
ei ian i	五岳毁天地 拳为天地
an ei ian i	拳为天地
eng u	二龙争珠 二龙争珠 二龙争珠 二龙争珠 云龙风虎 云龙风虎 啄目争珠 杀心成佛 舍身成佛 饿龙争珠 饿龙争珠
ong eng u	二龙争珠 二龙争珠 二龙争珠 二龙争珠 云龙风虎 云龙风虎 饿龙争珠 饿龙争珠
vn ong eng u	云龙风虎 云龙风虎
v u	守若巨木 鸿渐于陆 鸿渐於陆 鸿渐於陆
o v u	守若巨木
ou o v u	守若巨木
ang ao	五路阳爪 天上道 天香爪 夺命狼爪 怒涌狂潮 恶鹰藏爪 无常爪 火里藏刀 烈阳刀 绵里藏刀 逆水狂濤 阴阳道 龙翔爪
ong ang ao	怒涌狂潮 龙翔爪
u ong ang ao	怒涌狂潮
o II	修罗指 千夫所指 天残破石 天王破日 惊虹破日 意无所执 拨势 残鹰落日 爆破式 狂龙破日 狂龙破日 神鹰破日 空元破日 群鹰夺食 若有所失 開天破日 鹰王破日 鹰王破日
ong o II	惊虹破日 狂龙破日 狂龙破日
ang ong o II	狂龙破日 狂龙破日
v ong	冰锁虚空 冰锁虚空 割碎虚空 大日虚空 拳殛虚空 拳碎虚空 破虚空 雷霆忿怒破虚空
i v ong	拳殛虚空
an i v ong	拳殛虚空
u ang	一菩渡江 万寿无疆 份与物忘 佛掌 剑无双 功德无量 劫无相 千手无量 千毒掌 喜无量 四方如来气无量 大海無量 天佛掌 悲无量 慈无量 慈无量 拳殛无量 搜索枯肠 搜索枯肠 摩诃无量 狂濤無量 狂龍無量 舍无量 运转无常 进马出掌 迷窍毒掌 铁血无双 阴阳无常 阴风毒掌 降魔千佛掌 驚濤無量
i u ang	喜无量 四方如来气无量 拳殛无量
an i u ang	拳殛无量
ong ing	五雷轰顶 千雷轰顶 双雷轰顶 天雷轰顶 龙形
ei ong ing	五雷轰顶 千雷轰顶 双雷轰顶 天雷轰顶
ang ei ong ing	双雷轰顶
ie an	五道邪元 天罡邪拳 挖心裂胆 无界拳 涅槃七劫拳 火凤涅磐 烽火烈拳 螺旋烈转 裂肝
ang ie an	天罡邪拳
ian ang ie an	天罡邪拳
ou ang	万世流芳 推酒掌 枕肘撞 爆裂肘撞 百毒千手掌 连环扣撞 首阳 鬼头降
ei ou ang	推酒掌 鬼头降
ve i	唐门四绝器 生血祭
eng ve i	生血祭
v o	地狱火 祝融浴火
i v o	地狱火
o ou	丝前搏后 侧身右过肘 修罗咒 冥狱火球 大悲佛手 如来千佛手 炼狱真火球 白骨锁喉 破脑锁喉 魔佛手 魔眸
ou o ou	侧身右过肘 修罗咒
ei ie	轮回劫
en ei ie	轮回劫
ai o	大海破 如来破 童子拜佛 罗汉拜佛
a ai o	大海破
u an	六神不安 大罗佛圈 尸骨如山 瀑布渊 炼骨关 烈阳毒拳 生灵涂炭 羝羊触藩 铁布衫 铁布衫
u u an	尸骨如山 瀑布渊
ai ao	以逸代劳 怒海啸 暴海啸 血在烧
ao ai ao	暴海啸
ao ang	凤凰朝王 凤鸣朝阳 双凤朝凰 咏春标掌 回潮浪 张果老倒骑毛驴摔在高桥上 火伞高张 灵霄象 绞肠 逍遥掌 雪雹象 颠阴倒阳 鹰翱翔
ei ao ang	回潮浪
ao ong	万佛朝宗 万佛朝宗 万佛朝宗 大力鹰爪功 明暗交融 暴潮涌 暴轰 铁沙虎爪功
ao ao ong	暴潮涌
ian ai	天籁 百穴遍海 精卫填海 青天开
ve ian ai	百穴遍海
ai ve ian ai	百穴遍海
a an	佛问珈蓝 佛问珈蓝 佛问珈蓝 佛问珈蓝 凶豹杀拳 利涉大川 利涉大川 地煞拳 天仙下凡 天地霸拳 天煞拳 怒劈华山 怒劈华山 杀拳 横扫千军象拔拳 猛虎下山 苍狼歼霸拳 血道杀拳 西岳华山 金刚下凡 铁杀拳 风沙霸拳 龙涉大川 龙霸拳
i a an	天地霸拳 怒劈华山 怒劈华山
ian i a an	天地霸拳
u ai ao	怒海啸
ve eng	冰山雪崩 千岳崩
ian ve eng	千岳崩
ao an	五行豹拳 何仙姑乱睡象牙床左右搅反 凶兽暴拳 十万刀山 圣火燎原 地火燎原 地火燎原 天火燎原 无道拳 火凤燎原 狂飙卷 离火燎原 绞旋 绞转 老僧挑担 鬼火燎原
ang ao an	狂飙卷
v ai	火雨盖
o v ai	火雨盖
ong en	萧萧杀杀灭红尘 血染红尘 醉看紅塵 震红尘
en ong en	震红尘
ang eng	因果相承 怒毁长城 无有相生 暴雨狂风 苍茫冷 血肉长城 血肉长城 醉守蒼生 难以相成
ang ang eng	苍茫冷
ve ian	日月变 碧雪剑 虎跃涧
II ve ian	日月变
ou ie	星宿灭
ing ou ie	星宿灭
i i	万物齐一 三元及第 九阳大霹雳 九阳小霹雳 冬日熙熙 切肉离皮 地极 天地寂 天雷霹雳 寒冰霹雳 意极 晴天霹雳 殛脾 混元七殛 烈阳霹雳 神雷一击 群邪辟易 裂头霹雳 阴阳两极气 雷电霹雳 雷霆一击 震雷霹雳 霹雳 鬼神辟易
ian i i	天地寂 晴天霹雳 雷电霹雳
u en	五内如焚 五内如焚 唯我独尊 天魔怒震 惟我独尊 明镜拂尘 莫然无魂 追魂十五滚 雾雰 魔无神
o u en	唯我独尊 天魔怒震 惟我独尊 魔无神
ei o u en	唯我独尊 惟我独尊
ei an	七剑归元 万剑归元 九阴归元 二脉归元 人关紫蓝内丹 修罗黑雷拳 地关碧绿内丹 天关赤红内丹 奔雷拳 暴雨雷拳 波动雷拳 泽地归元 烈旋水转 熊掌推山 睡拳 紫气归元 荡气回旋 醉拳 铁家雷拳 铁牛推山
ou ing	万变犹定 梦游行 豹打流星 飞影流星
eng ou ing	梦游行
ao ing	伸腰顶 美人照镜 豹形 霜履薄冰 霜河倒影
en ao ing	伸腰顶 美人照镜
en ou ang	枕肘撞
o ian	抽尸剥茧 真火托天 花火炼 连环火箭 醉卧眠 霍电 龙破天
ei o ian	醉卧眠
ei en	前九式逆转反扑归真 天残飞轮 归真 惊雷震 翻睡滚 蝎尾追魂 追恨 追神 追魂 鬼手追魂 鹰喙追魂
an ei en	天残飞轮 翻睡滚
ou an	千手拳 大慈咒圈 敬酒拳 汉钟离手使阴阳宝扇左右扇 风卷楼残 骑虎搜山
ing ou an	敬酒拳
ou ou	尸撕裂魂搜飕手 曹国舅仙人敬酒锁喉扣 杯扣手 行尸走肉 裂分九州 醉拳扣手 锁喉扣 雷动山河震九州
ei ou ou	杯扣手
o ou ou	曹国舅仙人敬酒锁喉扣 锁喉扣
eng II	毒蜂指 破埕指 节外生枝 赤云封日 追风式 问风式 风势
o eng II	破埕指
u a	化作春泥更护花 天地无涯 无影无踪步法 气海无涯 火海无涯 猛虎出押 穹苍无涯 苦海无涯 血海无涯 配合步法 配合步法 配合步法 配合步法 配合步法 配合步法 配合步法 配合步法 配合步法 配合步法 配合步法 配合步法 配合步法 银月无华
e u a	配合步法 配合步法 配合步法 配合步法 配合步法 配合步法 配合步法 配合步法 配合步法 配合步法 配合步法 配合步法 配合步法
ei e u a	配合步法 配合步法 配合步法 配合步法 配合步法 配合步法 配合步法 配合步法 配合步法 配合步法 配合步法 配合步法 配合步法
ei u	一心不赘物 以有为无 凌波微步 炼石碎骨 醉步 醉步 醉步 醉步 魅影鬼步 魅影鬼步
ian a an	天仙下凡 天煞拳 苍狼歼霸拳
ang ian a an	苍狼歼霸拳
en a	一缕轻烟身法 佛祖问法 天妖屠神法 奇门遁甲 幻魔身法 招魂杀 玄宇宙身法 瞬杀 追魂杀 配合身法 配合身法 配合身法 配合身法 配合身法 鬼影身法
u i	云龙无际 五情无敌 呆若木鸡 土级 土级 圣火护体 天道无极 天雷怒劈 攻无不克战无敌 木级 木级 杀器护体 梵我如一 燁阳不息 物极 盘古五极 盘古击 神火护体 离心独劈 突击 紫菩提 紫菩提 紫阳无极 红菩提 绿菩提 翻天覆地 蓝菩提 逍遥无极 金菩提 银菩提 鬼斧劈 魔光日无极 魔光月无极 黄菩提 黑菩提
ei ao	勾魂鬼爪 围剿 夺魄鬼爪 带马归槽 幽冥鬼爪 玄阴鬼爪 虎尾脚 虎尾脚 赤炼鬼爪 韩湘子擒碗击胸醉吹箫 饿鬼道
ao II	佛光耀世 咏春标指 围剿式 并步右标指 招式 本末倒置 焰龙抱日 焰龙抱日 绞噬 醉入花丛人笑痴 雷电交织 雷电交织
ai ie	內解&外解 战龙在野 战龙在野 战龙在野 战龙在野 战龙在野 百裂 龙战在野
v ve	伤心欲绝 浴血
I ian	天魔撕天 幻魔四变 撕天 无柱撕天 杀地撕天 气吞紫电 紫旋撕天 紫焰 血阳撕天
ong a an	龙霸拳
ang ong	一剑藏空 二虎藏踪 大力金刚功 大无相功 小无相功 掌藏龙 无相功 日曜长空 易经降龙 正一纯阳功 火精当空 烈火焚阳功 直捣黄龙 移形分阳功 藏虎藏龙 血染长空 赤盖四阳功 铁血长空 铜像功 霹雳狂龙 霹雳狂龙 霹雳狂龙 霹雳狂龙
i ang ong	霹雳狂龙 霹雳狂龙 霹雳狂龙 霹雳狂龙
i i ang ong	霹雳狂龙 霹雳狂龙 霹雳狂龙 霹雳狂龙
ian en	以气炼神 倒转乾坤 变身 如意电震 怒龙现身 意守乾坤 指定乾坤 无殛电轮 易转乾坤 桥运乾坤 电锁乾坤 苍苍茫茫碎乾坤 蛛网乾坤 观心千手震乾坤 运转乾坤 逆乱乾坤 逆转乾坤 逆风移位运转乾坤 闻风先遁 雷霆电震 霹雳电震
ong ian en	怒龙现身
u ong ian en	怒龙现身
ou ian	威震九天 杞人忧天 狂狼吼天 雷动九天 雷动九天 雷动九天 雷动九天 雷行九天 龙啸九天 龙在九天 龙在九天 龙在九天 龙在九天 龙在九天 龙在九天 龙在九天 龙在九天
en ou ian	威震九天 杞人忧天
ei en ou ian	威震九天
ong eng	怒海纵横 怜我众生 普渡众生 普渡众生 百毒纵横 豹纵横 铁蹄纵横 铜马纵横 魔渡眾生 龙影纵横 龙影纵横 龙影纵横 龙影纵横
ing ong eng	龙影纵横 龙影纵横 龙影纵横 龙影纵横
ong ing ong eng	龙影纵横 龙影纵横 龙影纵横 龙影纵横
ai ong eng	怒海纵横
u ai ong eng	怒海纵横
ao ou ian	龙啸九天
ong ao ou ian	龙啸九天
o u	争睛夺目 五指如山乾坤定之如来佛祖 分筋错骨 天残破木 天魔舞 披霜拨露 穷途末路 虚怀若谷 鹰喙夺珠 龙涡步
ong o u	龙涡步
e a an	利涉大川 利涉大川 地煞拳 龙涉大川
u ian	九转珠连 佛光初现 佛光初现 佛光初现 佛光初现 佛光初现 佛法无边 佛法无边 佛法无边 佛法无边 劫如电 双莲吐艳 採虹补天 无限 火海无边 火海无边 火龙初现 火龙初现 电光初现 电光初现 电光初现 睡佛锄奸 穹苍无边 苦海无边 裹足不前 诛天 豹逐电 速限 风火无边 风霜扑面 龙虎出现
u u ian	睡佛锄奸 裹足不前 龙虎出现
o u u ian	裹足不前
I ong	无地自容 童子功
i I ong	无地自容
u i I ong	无地自容
a ian a	独霸天下
u a ian a	独霸天下
en ong	一以贯之神功 万里焚空 上天下地至尊功 九阳神功 九阳神功 圣火神功 圣火神功 大梦神功 密宗神功 左右神龙 左右神龙 左右神龙 左右神龙 弹指神通 弹神通 旋神通 无相神功 暮鼓晨钟 火焰神功 烈阳神功 烈阳神功 狮王神功 绝地困龙 罗刹魅神功 至尊功 般若神功 菩提证法神功 贯神通 轩辕三罡神功 逍遥令神功 逍遥派神功 鄂家神功 金甲神功 震空 霸王神功 霹雳震空
i en ong	万里焚空 绝地困龙 霹雳震空
ve i en ong	绝地困龙
ian ou	咏春小念头 煞戮千秋 花间游
u ian ou	煞戮千秋
a u ian ou	煞戮千秋
en an	人关 咏春拳 圣火神拳 大梵天震禅 天怒人怨 炼火焚拳 狂雷震撼 狮王神拳 神关 翻天覆地绝人寰 银弧寸断
u en an	天怒人怨 银弧寸断
ian u en an	天怒人怨
u ong	单虎出洞 双狼出洞 天理不容 密宗黑教武功 抽手护胸 无影无踪 毒蛇出洞 潜龙勿用 潜龙勿用 潜龙勿用 潜龙勿用 潜龙勿用 甲骨功 百剑无踪 罗汉出洞 配合毒功 配合毒功 配合毒功 金刚出洞 青龍出洞 青龙出洞 青龙出洞 青龙出洞 青龙出洞 青龙出洞 青龙出洞 青龙出洞
i u ong	天理不容
ian i u ong	天理不容
ian e	撼山陷地 血淹地 风云变色 风驰电掣
vn ian e	风云变色
eng vn ian e	风云变色
en ei an	奔雷拳
u ei ong ing	五雷轰顶
ai ian	千锤百炼 山海篇 旱雷开天 盘古开天 见龙在田 见龙在田 见龙在田 见龙在田 见龙在田 见龙在田 见龙在田 见龙在田 见龙在田 靛海剑 飞龙在天 飞龙在天 飞龙在天 飞龙在天 飞龙在天 飞龙在天 飞龙在天
ei ai ian	千锤百炼 旱雷开天
an ei ai ian	旱雷开天
ang ei	五怒狂雷 大力金刚腿 密宗金刚腿 少林金刚腿 帝天狂雷 帝天狂雷 断土狂雷 暴雨狂雷 暴雨狂雷 暴雨狂雷 标指双飞 百变烈阳腿 盘龙双飞 虎皇腿 蝶影双飞 蝶舞翩翩戏香蕊 蟠龙双飞 蟠龙双飞 蟠龙双飞 金豹双捶
v ang ei	暴雨狂雷 暴雨狂雷 暴雨狂雷
ao v ang ei	暴雨狂雷 暴雨狂雷 暴雨狂雷
en ao	人道 懒佛伸腰 懒豹伸腰 懒龙伸腰 第十三重鬼哭神号 膀手沉腰 蚀骨春宵 金刚伸腰 震脑 鬼门道 鬼门道
ao ei	一星抛捶 二星抛捶 冲天豹捶 双动豹鎚 爆肺 虎眼豹捶 霹雳暴雷
ei in	万毒归心 五世轮回印 五世轮回印 如来摧心 碎骨摧心 锥心
o an	借醉三分战意狂之伏虎罗汉 刻骨破腕 天罗汉 天雷破山 怒打罗汉 涡旋 炎火钻 烈风涡旋 王婆拨扇 癫罗汉 睡罗汉 破胆 笑罗汉 醉罗汉 龙腾火渊 龙腾火渊
ve ei	五岳摧 阳世五绝腿
u ve ei	五岳摧 阳世五绝腿
ong ve	五行轰岳 双仙拱月 心恶痛绝 撼东岳
an ong ve	撼东岳
i ve	九阴遗诀 乾坤七绝 崩西岳 灵蛇七绝 神魔同体诀 第八重厉鬼啼血
eng i ve	崩西岳
an ve	七残诀 人寰惨绝 刀章三诀 化金元诀 双芒赶月 坤仑断岳 天残三绝 扫南岳 折骨断绝 残虐 毒蛇探穴 灵蛇探穴 第一阳心坎穴 紫电断岳 达摩三绝 飞星赶月
ao an ve	扫南岳
ei ve	第九阳百会穴 翻天碎月 转北岳
an ei ve	转北岳
ve ei ian i	五岳毁天地
ang en an	狮王神拳
II ang en an	狮王神拳
II in	恶狮擒 雄狮劲
ong II in	雄狮劲
II ou	咏春窒手 咏春黐手 天魔蚀肉 怒狮吼
u II ou	怒狮吼
II u	仙人指路 勾魂蚀骨 天魔蚀骨 左右互搏之术 恶狮扑 络脉十五
e II u	恶狮扑
II II	吸天蚀日 天残蚀日 恶狼噬日 狂狮噬 白华蚀日 盘龙蚀日 贪狼噬日 鹰王噬日
ang II II	恶狼噬日 狂狮噬 贪狼噬日 鹰王噬日
ve an	五岳拳 修罗灭绝拳 天残杀月斩 崩雪斩
u ve an	五岳拳
a ing	凌云压顶 十全霸境 泰山压顶 狼王压顶 铁桥八形 阎王十杀令 飞龙压顶 飞龙压顶 飞龙压顶
an a ing	十全霸境 泰山压顶
ai an a ing	泰山压顶
u i a an	怒劈华山 怒劈华山
eng an	北岳恒山 南岳衡山 左右逢源 轰雷旋风转 通胜拳 风涌恒山
ong eng an	通胜拳 风涌恒山
eng ong eng an	风涌恒山
ve a	穹苍血甲 衡山跃马
an ve a	衡山跃马
eng an ve a	衡山跃马
an vn	万仞穿云 万刃穿云 嵩山穿云 日燄捲雲 火箭穿云 破风断云 裂空断云 金剑穿云 雷霆万钧 雷霆万钧 风卷残云 风卷残云 风卷残云 风卷残云 风卷残云 龙卷残云 龙翻云
an an vn	嵩山穿云 风卷残云 风卷残云 风卷残云 风卷残云 风卷残云 龙卷残云
ong an an vn	嵩山穿云 龙卷残云
ei eng	回梦 地火围城 跟红顶白反败为胜 追梦 追风
ai ei eng	跟红顶白反败为胜
an ai ei eng	跟红顶白反败为胜
an ian en	倒转乾坤 易转乾坤 运转乾坤 逆乱乾坤 逆转乾坤 逆风移位运转乾坤
vn an ian en	运转乾坤 逆风移位运转乾坤
an ang	三阳 光芒万丈 十三象 千罗万网 千罗万网 哭断肠 大小通吃围杀三方 天地玄掌 开山掌 抱酲徜徉雲端上 沉桥串掌 玄冰寒掌 生离死别催肝肠 百步穿扬 禅枪 苦难掌 蛟龙翻江 蛟龙翻江 蟠龙翻江 蟠龙翻江 银月幻掌
a an ang	大小通吃围杀三方
ei a an ang	大小通吃围杀三方
II en	万恶世尊 人七地八双天至尊 先发制人 天魔蚀魂 惡兽噬神 解心释神
ian II en	人七地八双天至尊
ang ian II en	人七地八双天至尊
ian an	三通连环 元空天轉 八分箭拳 前铲 合纵连环 天关 天心莲环 张果老醉酒抛杯踢连环 惨绝人寰扣连环 日月天残 火箭拳 火豹连环 火龙千转 脥底箭拳 蝶掌连环 豹子连环 铁线拳 铜炮连环 麟霸千山
ie ian an	铁线拳
u ao	三度珠桥 九死白骨爪 九死白骨爪 九阳普照 九阴白骨爪 佛光普照 佛光普照 佛光普照 兽穴法＆虎爪 剔骨道 剔骨道 唐手武道 四绝白骨爪 回天無道 地无道 外王六艺——书道 天穹五道 子午珠桥 暴雷诛妖 杀无道 梵炉道 梵炉道 烈阳普照 烈阳普照 狂无道 百毒爪 碎骨爪 神风怒嚎 裂骨爆 邪无道 金锣普照 铁骨桥 阴阳毒爪 降魔伏妖
u u ao	三度珠桥 子午珠桥
an u u ao	三度珠桥
eng ao an	火凤燎原 老僧挑担
ao eng ao an	老僧挑担
e ao	合招 合招 合招 合招 奈何道 奈何道 开弓射雕 风云合招
ong e ao	开弓射雕
ai ong e ao	开弓射雕
ing ou	提壶敬酒 灵台清幽 灵台清幽 百足无影手
u ing ou	提壶敬酒 百足无影手
i u ing ou	提壶敬酒
ong ong	夢打銅鍾 拳打中宫 月魂憧憧 杀手空空 醉踏風火闹龙宫
a ong ong	夢打銅鍾 拳打中宫
an a ong ong	拳打中宫
ang ve	刀剑双绝 圣王诀 推窗望月 灭阳诀 电光攫 第七阳脊梁穴 第八阳至阳穴 豫嫇望月 霜雪
ang ang ve	推窗望月
ei ang ang ve	推窗望月
ou a	转身扣杀
en ou a	转身扣杀
an en ou a	转身扣杀
ou u ong	抽手护胸
ou ou u ong	抽手护胸
in an	分金拳 千手百臂观音乱 无敌金环 蛟龙临渊 螳螂问心圈 观音乱 锻筋关
en in an	分金拳 螳螂问心圈
an ian	一念三千 千焚萬炼 地网翻天 宝鸭穿莲 开山鉴 掩护丹田 无间串莲 曦轮万千 淚佛觀天 狂狼斩天 破邪三限 禅箭 禅鞭 蓝焰 达摩禅剑
u an ian	掩护丹田 淚佛觀天
ian u an ian	掩护丹田
ing ang an	北斗冥王拳
ou ing ang an	北斗冥王拳
ing en	惊神 蝎尾钉魂 转法经轮 转法经轮 雷霆震 魔冰盾
o ing en	魔冰盾
ong o	冥王苍空破 天龙锁 天龙锁 天龙锁 天龙锁 蛟龙错
ang ong o	冥王苍空破
ang ang ong o	冥王苍空破
ang o	伏妖降魔 冥王天翔破 双雷荡魄 巨佛降魔 掛捶双落 掛捶双落 阳火 阴差阳错 阴差阳错 阴阳错
ian ang o	冥王天翔破
ang ian ang o	冥王天翔破
II ian	尸变 玄冰之箭
ing II ian	玄冰之箭
an ing II ian	玄冰之箭
ing an	七十二路空明拳 五形拳 流星贯 破冰钻 神鹰版 精关 虎鹤双形拳
ang ing an	虎鹤双形拳
e ang ing an	虎鹤双形拳
ong u u ian	龙虎出现
u ang ong	二虎藏踪 大无相功 小无相功 无相功 藏虎藏龙
er u ang ong	二虎藏踪
ang u ang ong	藏虎藏龙
ei en ao ing	美人照镜
ai ou	七箭截脉手 唐尸三百手 探花截脉手 斜风摆柳 迎风摆柳
eng ai ou	斜风摆柳 迎风摆柳
ie eng ai ou	斜风摆柳
ang a	二字钳阳马 人煞掌法 侧身钳阳马 劈空掌法 地缺掌法 大漠魔狼杀 天残掌法 天狼杀 玄卦挡煞 袖里藏花 邪风掌法 销魂掌法
i ang a	袖里藏花
ou i ang a	袖里藏花
ong an	中岳嵩山 千手铜拳 崆峒神通拳 恶龙缠 恶龙缠 恶龙缠 恶龙缠 恶龙缠 恶龙缠 指定中原 指定中原 日字冲拳 毒龙钻 毒龙钻 电光毒龙钻 电光毒龙钻 电光毒龙钻 箭腿毒龙钻 虎啸中原 赤手凶拳 轰天雷动拳 进马冲拳 进马冲拳 连环冲拳 铜拳 龙拳
ing ong an	指定中原 指定中原
II ing ong an	指定中原 指定中原
i ei	乌龙戏水 游龙戏水 游龙戏水 灭寂腿 辟地碎 雷兮天地碎 风云际会
ong i ei	乌龙戏水 游龙戏水 游龙戏水
u ong i ei	乌龙戏水
eng ian	一步登天 四指撑天 指尾撑天 日字猛箭 银月圣典 银月圣典
II eng ian	四指撑天
I II eng ian	四指撑天
ei ong	万法归宗 千雷归宗 四炁归宗 恶雷轰 摇龙归洞 穿桥归洞 血火雷动 配合任何内功 风舞雷动
ong ei ong	摇龙归洞
ao ong ei ong	摇龙归洞
u u	一将功成万骨枯 七级浮屠 乌龙吐珠 双弓伏虎 孤狼扑兔 慈航普渡 易筋经七级浮屠 浑然无物 火龙吐珠 火龙吐珠 灵龙吐珠 玄坛伏虎 白级浮屠 白级浮屠 紫级浮屠 红级浮屠 红级浮屠 蓝级浮屠 蓝级浮屠 赤龙吐珠 雄鹰扑兔 青级浮屠 飞鹰扑兔 饿虎扑兔 饿鹰扑兔 鸟渡术 黄级浮屠 黄级浮屠 黑级浮屠 黑级浮屠
ong u u	乌龙吐珠 双弓伏虎 火龙吐珠 火龙吐珠 灵龙吐珠 赤龙吐珠
u ong u u	乌龙吐珠
an a	两极玄甲 仙女散花 千军万马 千军万马 千鬼邪元杀 手扳丹蛙 蚀月三杀 还魂拳法 铁铠战甲 风箱拳法
ang an a	风箱拳法
eng ang an a	风箱拳法
a a	九死轮回大法 九玄大法 乾坤大法 伏羲画卦 双弓插花 四平大马 天地大法 天地大法 天魔秘大法 寒麟化甲 梵我不二大法 猛虎扒沙 猛虎抓沙 神行八法 金禅袈裟 金禅袈裟 阴阳大法
ing a a	四平大马 神行八法
I ing a a	四平大马
II ve	双提日月 空懷日月 红日诀 红日诀
i II ve	双提日月
ang i II ve	双提日月
ang i	一转八罡气 七十二罡气 七转五十六罡气 三转二十四罡气 乌鸦晾翼 九转七十二罡气 二转十六罡气 五转四十罡气 八转六十四罡气 六转四十八罡气 反两仪 問誰能破四面手之梵天上帝 四转三十二罡气 地霸气诀之阴阳玄刚气 旭阳级 昊天罡气 正两仪 火雷罡气 烈阳刚气 烈阳级 白虹掌力 纯阳级 飞马张翼
a ang i	一转八罡气 乌鸦晾翼 六转四十八罡气 飞马张翼
u a ang i	乌鸦晾翼
ong a a	双弓插花
ang ong a a	双弓插花
a an ian	宝鸭穿莲
ao a an ian	宝鸭穿莲
u ai	倒叩如来 千龙出海 单龙出海 双龙出海 双龙出海 双龙出海 双龙出海 双龙出海 双龙出海 双龙出海 双龙出海 煮海 神驰物外 神龙出海 苦海 金刚不坏 颠云覆海
ong u ai	千龙出海 单龙出海 双龙出海 双龙出海 双龙出海 双龙出海 双龙出海 双龙出海 双龙出海 双龙出海 神龙出海
ang ong u ai	双龙出海 双龙出海 双龙出海 双龙出海 双龙出海 双龙出海 双龙出海 双龙出海
ing ang	万里鹰扬 傲雪凌霜 千鹰并翔 蓉桂兢芳 金桥定相 雷霆象
ao ing ang	金桥定相
in ao ing ang	金桥定相
ou ao	丹影手脚 九幽爪 凶兽道 右运柔桥 左运柔桥 心惊肉跳 杀龙求道 猴子偷桃 石黑龙自创柔道 空手道 裂头脚
vn ou ao	右运柔桥 左运柔桥
o vn ou ao	左运柔桥
ou vn ou ao	右运柔桥
ao ve	双弓抱月 水底捞月 海底捞月 霜寒抱月
i ao ve	水底捞月 海底捞月
ei i ao ve	水底捞月
v ing	姗姗绿影 霸王举鼎
ang v ing	霸王举鼎
a ang v ing	霸王举鼎
ong ian i	轰天击 轰天殛 雷动天地 飞鸿敛翼
ei ong ian i	雷动天地 飞鸿敛翼
ie ao	双剑切桥 菩萨灭道 血劫爪 贝叶刀
ian ie ao	双剑切桥
ang ian ie ao	双剑切桥
o ai	右手破排 左手破排 无边火海 蛟龙过海 飞将夺帅 魔带
ou o ai	右手破排 左手破排
o ou o ai	左手破排
ou ou o ai	右手破排
ang ong u u	双弓伏虎
i ian	两仪剑 力限 惊虹一现 无殛电 昙花一现 灵犀一点 猫儿洗脸 疾电 迎佛西天 迎佛西天 迎佛西天 迎佛西天 雷神疾电 青气现
er i ian	猫儿洗脸
ao er i ian	猫儿洗脸
a ian i	白马献蹄 飞马献蹄 龙跨千里
ai a ian i	白马献蹄
ian u	伏羲问天录 伏虎连珠 莲步 蛇形电步 蛇形电步 霜凝见绌
u ian u	伏虎连珠
u u ian u	伏虎连珠
I u u ao	子午珠桥
ao an ang	沉桥串掌
en ao an ang	沉桥串掌
ei eng ian	指尾撑天
II ei eng ian	指尾撑天
a an ao	坐马单桥 夜叉探爪
o a an ao	坐马单桥
a u ang	进马出掌
in a u ang	进马出掌
an u u	一将功成万骨枯 浑然无物 玄坛伏虎
an an u u	玄坛伏虎
ang u ong	双狼出洞 金刚出洞
in ang u ong	金刚出洞
ian II	两茧势 乾日 云开见日 削竹连枝 后发先至 女娲炼石 惊天式 暗无天日 滔天势 疾电势 疾电式 纯阳乾天指 纯阴玄天指 般若梵天指 问电式 雪花仙指 黏势
u ian II	削竹连枝 暗无天日
ve u ian II	削竹连枝
vn e	拨草寻蛇
ao vn e	拨草寻蛇
o ao vn e	拨草寻蛇
ao ou	密宗龙爪手 幻魅妖球 撕心裂肺龙爪手 水浪抛球 浪里抛球 蛇形刁手 铁龙爪手 龙爪手 龙爪手 龙爪手
i ao ou	浪里抛球
ang i ao ou	浪里抛球
i ou	五雷化殛手 寒冰霹球 断筋破骨大劈手 混元霹雳手 紫气收 裂魔霹雳手 观空大劈手 魁星踢斗 魁星踢斗
ing i ou	寒冰霹球 魁星踢斗 魁星踢斗
ei ing i ou	魁星踢斗 魁星踢斗
ong ao ve	双弓抱月
ang ong ao ve	双弓抱月
I ai o	童子拜佛
ong I ai o	童子拜佛
u v	猛虎负隅 翻云覆雨 翻云覆雨 翻云覆雨
u u v	猛虎负隅
eng u u v	猛虎负隅
ian ao ei	冲天豹捶 虎眼豹捶
u ian ao ei	虎眼豹捶
i an ao	独臂单桥 独臂单桥
u i an ao	独臂单桥 独臂单桥
a ong an	进马冲拳 进马冲拳
in a ong an	进马冲拳 进马冲拳
ian I	单工千字 单工千字 双工千字 双工千字 吊脚千字 百媚千姿
ong ian I	单工千字 单工千字 双工千字 双工千字
an ong ian I	单工千字 单工千字
ang ong ian I	双工千字 双工千字
ei a	双掛捶法 双掛捶法 般若腿法 芙蓉腿法 铁家腿法 霸王腿法 龟甲 龟甲
a ei a	双掛捶法 双掛捶法 铁家腿法
ang a ei a	双掛捶法 双掛捶法
ei ang o	双雷荡魄 掛捶双落 掛捶双落
a ei ang o	掛捶双落 掛捶双落
an II	一以贯之 冰封三尺 冰封三尺 冰封三尺 判官指 千虫万噬 双虹贯日 幻势 探势 断肢 暴雷三式 横死三式 流星赶日 浪卷势 深渊势 玉簪指 白虹贯日 罗汉禅指 观音乱世 通天拳势 阴阳三式 鹤展翅 鹰变十三式
ian an II	通天拳势
ong ian an II	通天拳势
ong ian	一飞冲天 中冲剑 关冲剑 冰火七重天 冰火五重天 冰火五重天 凤吼冲天 双箭击通天 大冲剑 少冲剑 少冲剑 暴雷轰天 灭水空焰 红焰 红焰 苍龙动天 血冲天 连环通天 铁龙剪 铁龙剪 雄鹰冲天 魔光七重天
an ong ian	关冲剑 连环通天
ian an ong ian	连环通天
en ian an	八分箭拳
a en ian an	八分箭拳
en an a	还魂拳法
an en an a	还魂拳法
ao ian I	吊脚千字
ao ao ian I	吊脚千字
ie u	屠神灭佛 转身撇竹 铜皮铁骨
en ie u	屠神灭佛 转身撇竹
an en ie u	转身撇竹
an ei	乾坤裂山腿 六转幻腿 天残腿 天残腿 天花乱坠 天花乱坠 天花乱坠 天花乱坠 寒刀断水 恶电三摧 旱雷 禅雷 追命十三腿 铁门闩捶 锻髓 阴世幻腿
en an ei	铁门闩捶
ie en an ei	铁门闩捶
en ei	七转轮回 万劫不复堕轮回 九劫轮回 五世轮回 再世轮回 天马神腿 拜揖门楣 无尽轮回 朱雀恨水 电光分飞 离恨分飞 紫阳裂神腿 蝴蝶分飞 裂地蟒神腿 达摩神腿 降龙神腿 雷电分飞 雷电神腿 雷电神腿 霜雪纷飞 霹雳神腿 青焰裂神腿 风神腿 魔佛輪迴 魔光绽春雷
ie en ei	九劫轮回 紫阳裂神腿 蝴蝶分飞 青焰裂神腿
u ie en ei	蝴蝶分飞
in ang	一指判阴阳 二转阴阳 双鹰擒蟒 摧心掌 摧心掌 阎罗殿里判阴阳 雨霖象 饿虎擒羊 饿豹擒狼
u in ang	饿虎擒羊
e u in ang	饿虎擒羊
u u ong	单虎出洞
an u u ong	单虎出洞
u a an	猛虎下山
eng u a an	猛虎下山
ai ang	惊涛骇浪 虎凭豺狼
ing ai ang	虎凭豺狼
u ing ai ang	虎凭豺狼
a ei ao	带马归槽
ai a ei ao	带马归槽
an an a	手扳丹蛙
ou an an a	手扳丹蛙
i in	挪移劲 洗心 热沙砾金 跌蒲麒麟
u i in	跌蒲麒麟
ie u i in	跌蒲麒麟
ou en ao	膀手沉腰
ang ou en ao	膀手沉腰
en i	三啸鬼神辟 五星战神气 人极 人极 先天纯阳真气 先天纯阴真气 天魂殛 完美神技 指手问题 痴心魂离 金晨曦 长生诀真气 雷神疾
ou en i	指手问题
II ou en i	指手问题
ang ao ou	水浪抛球
ei ang ao ou	水浪抛球
ong ei	八龙汇 扭马冲捶 日字冲捶 炙手轰雷 百兽同悲 袖里冲捶 迷踪腿
i ong ei	袖里冲捶 迷踪腿
ou i ong ei	袖里冲捶
en eng	万马奔腾 万马奔腾 天火焚城 天火焚城 天火焚城 赤盖焚城 铁沙焚城 饮恨吞声 鹤嘴沉睁
ei en eng	鹤嘴沉睁
e ei en eng	鹤嘴沉睁
ao e	大小着 狂蜂暴蜇 还魂饱鹤 还魂饱鹤
en ao e	还魂饱鹤 还魂饱鹤
an en ao e	还魂饱鹤 还魂饱鹤
ei e	独脚飞鹤
ao ei e	独脚飞鹤
u ao ei e	独脚飞鹤
ve e	残脚缺鹤
ao ve e	残脚缺鹤
an ao ve e	残脚缺鹤
vn a	仙鹤寻虾 饿鹤寻虾
e vn a	仙鹤寻虾 饿鹤寻虾
e e vn a	饿鹤寻虾
ing a	九霄雷霆霸 右鹤顶法 夺命杀 左鹤顶法 雁落平沙
e ing a	右鹤顶法 左鹤顶法
ou e ing a	右鹤顶法
o e ing a	左鹤顶法
ai ei	乌龙摆尾 拖泥带水 毒蛇摆尾 灵蛇摆尾 神龙摆尾 神龙摆尾 神龙摆尾 神龙摆尾 神龙摆尾 神龙摆尾 神龙摆尾 神龙摆尾 神龙摆尾 神龙摆尾 神龙摆尾 蝎子摆尾 蝎子摆尾 贴身快腿
ong ai ei	乌龙摆尾 神龙摆尾 神龙摆尾 神龙摆尾 神龙摆尾 神龙摆尾 神龙摆尾 神龙摆尾 神龙摆尾 神龙摆尾 神龙摆尾 神龙摆尾
u ong ai ei	乌龙摆尾
ai II	以虚还实 火龙拜日 石破天惊气盖世 罗汉晒尸 罗汉晒尸 银柳摆枝
an ai II	罗汉晒尸 罗汉晒尸
o an ai II	罗汉晒尸 罗汉晒尸
in u	兽心怒 卞崖擒虎 走麒麟步 阴阳邪毒功阴毒
a in u	卞崖擒虎
ian a in u	卞崖擒虎
a ian	地煞篇 天煞篇 海網撒天 醉八仙 醉八仙 醉八仙 醉酒八仙
ou a ian	醉酒八仙
ei ou a ian	醉酒八仙
an u ong	罗汉出洞
o an u ong	罗汉出洞
in ou	分金手 单指引手 才下心头 才下心头 逍遥三阴手 铁划银勾
II in ou	单指引手
an II in ou	单指引手
ing ao ei	一星抛捶 二星抛捶
i ing ao ei	一星抛捶
er ing ao ei	二星抛捶
e ou	恶毒灵蛇手 离踝折肘 连环责囚
an e ou	连环责囚
ian an e ou	连环责囚
an ou ang	连环扣撞
ian an ou ang	连环扣撞
i ian an	张果老醉酒抛杯踢连环 脥底箭拳
ian i ian an	脥底箭拳
ao a	勾弹脚法 大爆炸 无影脚法 神鹰八段锦爪法 黑虎爪法
an ao a	勾弹脚法
ou an ao a	勾弹脚法
an o ian	连环火箭
ian an o ian	连环火箭
a ao	归魂十八爪 混元无极大道 虎头铡刀 金星掛角 铁扫把脚 铁血狂杀道 阎罗八杀爪 阳关大道
ao a ao	铁扫把脚
ie ao a ao	铁扫把脚
I ou ao	猴子偷桃
ou I ou ao	猴子偷桃
u ao a	黑虎爪法
ei u ao a	黑虎爪法
ian ao	人间道 千浪千涛 大圣朝天脚 天道 无间道 无间道 朔漠天刀 猴王献爪 百蜇千螯 真魔天道 金龙献爪 金龙现爪
ong ian ao	金龙献爪 金龙现爪
in ong ian ao	金龙献爪 金龙现爪
en in	不动根本印 不动根本印 不动根本印 不动根本印 十字分金 大日轮印 大金刚轮印 截脉寸劲 日轮印 裂脉分筋 转法轮印 转法轮印 铁掌分金
I en in	十字分金
II I en in	十字分金
ing a ao	金星掛角
in ing a ao	金星掛角
u ou an	骑虎搜山
i u ou an	骑虎搜山
I eng ian	日字猛箭
II I eng ian	日字猛箭
o ing a	夺命杀 雁落平沙
ian o ing a	雁落平沙
u ie	以身入灭 双飞蝴蝶 无远弗届 空空如也 长生不灭
ei u ie	双飞蝴蝶
ang ei u ie	双飞蝴蝶
a ong ei	八龙汇 扭马冲捶
ou a ong ei	扭马冲捶
i in u	走麒麟步
ou i in u	走麒麟步
ie ang	之字蝶掌 无邪掌 有影皆双 血火邪罡 贝叶掌
I ie ang	之字蝶掌
II I ie ang	之字蝶掌
ang ian an	蝶掌连环
ie ang ian an	蝶掌连环
ing ou ao	丹影手脚 心惊肉跳
an ing ou ao	丹影手脚
u ve	九阳五绝 天魔五绝 怒碎五岳 炼铁手之炼铁手五诀 盘古真武诀 蓉莛暮雪 龙胜五岳 龙藏虎跃
ang u ve	九阳五绝 龙藏虎跃
ong ang u ve	龙藏虎跃
u a a	猛虎扒沙 猛虎抓沙
eng u a a	猛虎扒沙 猛虎抓沙
ao ang an	虎啸皇拳 虎豹双拳
u ao ang an	虎啸皇拳 虎豹双拳
ao ei ong	穿桥归洞
an ao ei ong	穿桥归洞
an ong u ai	单龙出海
i ing	刁打七星 神怡气静 虎鹤齐鸣 阳世奇经 阴世奇经 阴世奇经 龙潜迷冰 龙潜迷冰
e i ing	虎鹤齐鸣
u e i ing	虎鹤齐鸣
ong en an	咏春拳
ang ou	吕洞宾斜插宝剑醉跌岳阳楼 咏春樁手 咏春膀手 巨蝎昂首 鹰抢球
en ang ou	咏春樁手 咏春膀手
ong en ang ou	咏春樁手 咏春膀手
an ou	一本贯手 千般烦忧 千般烦忧 千鹰万寿 咏春按手 咏春摊手 天禅手 惊虹断流 推山手 断肢斩首 烈火断头 电光斩首 电光斩首 破元手 破空元手 空元手 翻兜 铁翼斩首 镰刀断头
en an ou	一本贯手 咏春按手 咏春摊手
ong en an ou	咏春按手 咏春摊手
u ou	一醉能解萬古愁 丝丝入扣 千蛛万毒手 咏春伏手 群龙无首 群龙无首 诛魅普渡咒
en u ou	咏春伏手
ong en u ou	咏春伏手
en ou	五绝杀神手 咏春问手 四步神游 断肠温柔 海市蜃楼 血河奔流 醉眼看天庭擎槍指神州 黄天当立震神州
en en ou	咏春问手 黄天当立震神州
ong en en ou	咏春问手
en II ou	咏春窒手 咏春黐手
ong en II ou	咏春窒手 咏春黐手
ao ian ou	咏春小念头
en ao ian ou	咏春小念头
a in	无常挖心 日光菩萨印 杀心 短程发劲 紫煞劲 鹰爪挖心 鹰爪挖心
eng a in	短程发劲
an eng a in	短程发劲
ou ao II	并步右标指
u ou ao II	并步右标指
en ao II	咏春标指 醉入花丛人笑痴
ong en ao II	咏春标指 醉入花丛人笑痴
II ang ei	标指双飞
ao II ang ei	标指双飞
ian ang a	二字钳阳马 侧身钳阳马 天狼杀
I ian ang a	二字钳阳马
en ou o ou	侧身右过肘
en ian ang a	侧身钳阳马
en ai ei	贴身快腿
ie en ai ei	贴身快腿
I ong an	日字冲拳
II I ong an	日字冲拳
I ong ei	日字冲捶
II I ong ei	日字冲捶
an ong an	连环冲拳
ian an ong an	连环冲拳
en ao ang	咏春标掌
ong en ao ang	咏春标掌
i ang	二阳霹雳掌 咏春劈掌 大须弥掌 天罗地网 火舞激扬 狂蜂纷飞酿蜜忙 霹雳象
en i ang	咏春劈掌
ong en i ang	咏春劈掌
ei ang	六月飞霜 北冥飞伤 千眼鬼王 双沉双推掌 地藏鬼王 振翅飞扬 摧囊 无界鬼王 森罗鬼王 电光鬼王 瘟疫鬼王 百虫鬼王 追浪 阴阳鬼王 饿兽鬼王
ang ei ang	双沉双推掌 地藏鬼王 电光鬼王 阴阳鬼王
en ang ei ang	双沉双推掌
ai en in	截脉寸劲 裂脉分筋
ie ai en in	截脉寸劲 裂脉分筋
u ao an	无道拳
e u ao	地无道
ang u ao	九阳普照 佛光普照 佛光普照 佛光普照 烈阳普照 烈阳普照 狂无道 阴阳毒爪
a u ao	杀无道
u ie an	无界拳
I ie	撕裂
o ei	三叠落梅 吸精夺髓 天魔锥 破碎 肢离火碎
ian ie	七逆寒天劫 万雷灰飞烟灭 天灭 灰飞烟灭 灰飞烟灭 烟灭
a en	封神虎杀阵 杀神
a ve	杀绝 赶尽杀绝 铜蹄踏雪
u ing an	五形拳
u ing	九生皆醉我獨醒 乾坤无定 乾坤无量/乾坤无定 仙气风飙处处行 南锋无定 变云无定 天地无情 天塌不惊 如影附形 幻龙无影 幻龙无影 水流心不惊 虎形
u u a	猛虎出押
eng u u a	猛虎出押
u u u	饿虎扑兔
e u u u	饿虎扑兔
ou in	九字真言手印 千豹投林 土豹投林 大金刚轮手印 大黑天手印 如来大手印 如来大手印 火烙手印 虎爪偷心 血手印 釜底抽薪 黑虎偷心 黑龙偷心 黑龙偷心 黑龙偷心 黑龙偷心 黑龙偷心 黑龙偷心
u ou in	黑虎偷心
ei u ou in	黑虎偷心
e ing	蛇形 鹤形
u in	内缚印 千刀不尽 千手佛印 外缚印 天无尽 昂首吐信 毒蛇吐信 火蛇吐信 火蛇吐信 白蛇吐信 碎骨劲 采阳补阴 雷霆无尽 霹雳龙虎劲
e u in	毒蛇吐信 火蛇吐信 火蛇吐信 白蛇吐信
ai e u in	白蛇吐信
an ong	一念圆融 三火归元功 义和大日玄功 冰海翻龙 冰海翻龙 十三龙 天蚕功 惊雷三轰 梅花三弄 毒虫钻洞 灵蛇钻洞 金刚盘龙 霹雳玄功 飞鹰盘空
e an ong	灵蛇钻洞
ing e an ong	灵蛇钻洞
e ai ei	毒蛇摆尾 灵蛇摆尾
u e ai ei	毒蛇摆尾
ong ong ian	中冲剑 苍龙动天
ang ong ong ian	苍龙动天
en ong u ai	神龙出海
eng ong	二步横空 云现风涌 殛电横空 毒蟒横空 神风动 血横空 雷横空 雷电横空 雷电横空 飞鹤腾空
e eng ong	飞鹤腾空
ei e eng ong	飞鹤腾空
ian e vn a	仙鹤寻虾
ong ao ei	双动豹鎚
ang ong ao ei	双动豹鎚
I ian an	豹子连环
ao I ian an	豹子连环
a ou ing	豹打流星
ao a ou ing	豹打流星
an i	三箭断璇玑 不倒三击 土星战气 小安息 无形暗器 暗器 木星战气 水星战气 火云万里 火星战气 灭神三极 無相破元气 至尊功之纯阴玄气 金星战气 鹰扬万里 龙啸万里 龙啸万里
ao an i	不倒三击 小安息 龙啸万里 龙啸万里
u ao an i	不倒三击
an ian e	撼山陷地
an an ian e	撼山陷地
ong ao ou	密宗龙爪手 撕心裂肺龙爪手 铁龙爪手 龙爪手 龙爪手 龙爪手
ong o ian	龙破天
ing ang II II	鹰王噬日
ong i	七箭碎中极 九龙壁 雷霆轰击
ou ong i	九龙壁
o ie an	烽火烈拳
eng o ie an	烽火烈拳
II ong u u	赤龙吐珠
ian o	借花献佛 左天罗 开天破 火网天罗 火网天罗 紫气天罗 紫气天罗 紫气天罗 紫电天罗 逆天破
ang ian o	火网天罗 火网天罗
o ang ian o	火网天罗 火网天罗
en ian	九阳神剑 九阳神剑 六脉神剑 刻骨分肩 地电震天 太极真焰 太火焚天 御火吞天 日月神鉴 日月神鉴 昆仑剑 暴焰焚天 混沌剑 火虹焚天 火龙吞天 火龙吞天 焚天 煮海焚天 蓝采和度沉疴就把花篮分献 血火沉天 达摩神剑 达摩神剑 逆阳神鉴 雷震天
ian en ian	地电震天 暴焰焚天
ao ian en ian	暴焰焚天
en ing	一啸红尘惊 九阴真经 九霄真经 九霄真经 九霄真经 山兮鬼神惊 楚庄王中原问鼎 血神经 血聚神凝 魔典真经
ong en ing	一啸红尘惊
ao ong en ing	一啸红尘惊
ai an	东岳泰山 五丁开山 以偏概全 再啸湖海翻 千漩百轉 或跃在渊 或跃在渊 或跃在渊 或跃在渊 或跃在渊 或跃在渊 泰拳 烈火开山 直排斩 阎王开山 龙跃在渊
u ai an	再啸湖海翻
ao u ai an	再啸湖海翻
ei en i	三啸鬼神辟 完美神技 雷神疾
ao ei en i	三啸鬼神辟
ang ie	绝啸穹苍灭 金刚解 铁拐撞铁
ong ang ie	绝啸穹苍灭
ao ong ang ie	绝啸穹苍灭
ou ong an	千手铜拳 赤手凶拳
II ou ong an	赤手凶拳
a in ou	才下心头 才下心头 铁划银勾
ie a in ou	铁划银勾
ong ang	二十三式降龙掌 八方龙王 十七式降龙掌 气夺穹苍 气盖穹苍 碎穹苍 穹苍 血归穹苍 血穹苍 血雨腥風洗穹苍 赤壁铜墙 金穹苍 铁臂铜墙 锁龙网 阳断穹苍 霸靇象
i ong ang	血雨腥風洗穹苍 赤壁铜墙 铁臂铜墙
II i ong ang	赤壁铜墙
ing ei	万劫鹰喙 十里惊雷 断魂蝎钉腿 旷野惊雷 暴电惊雷 暴雨惊雷 洹灵凝髓 贯之惊雷
i ing ei	十里惊雷
II i ing ei	十里惊雷
ian ong	七十二變化無窮之醉猴鬧天宮 卧虎潜龙 烈焰功 猴王酩酊鬧天宮 霸碎天宫 鬼劫仙功
u ian ong	卧虎潜龙
o u ian ong	卧虎潜龙
o i	万军莫敌 万物如我意 以意驳气 十万火急 十刀破极 如來破极 水挪移 火级 火级 白驹过隙 阴阳大挪移
vn o i	万军莫敌
an vn o i	万军莫敌
o en an	圣火神拳 炼火焚拳
ian o en an	炼火焚拳
ie ian i	一泻千里 分裂天地
en ie ian i	分裂天地
I an II	横死三式
eng I an II	横死三式
ie o	大解脱
a ie o	大解脱
i e	倒天逆地 天造地设 天魔极乐 早登极乐 终极乐 逆地
ong i e	终极乐
ie ang an	阴风烈阳拳
eng ie ang an	阴风烈阳拳
in eng	暴烈阴风
ie in eng	暴烈阴风
ao ie in eng	暴烈阴风
ie ang u ao	烈阳普照 烈阳普照
ao i	阴阳交击
ang ao i	阴阳交击
in ang ao i	阴阳交击
in ang an	密宗金刚拳 金刚钻 金刚钻 青城金刚拳
eng in ang an	青城金刚拳
ei o	天雷过 惊雷破 沉雷破 穹天赤雷破
en ei o	沉雷破
ai an ian	开山鉴
ian ei	万箭锥 五灭天雷 双龙剪水 双龙剪水 灭绝天雷 神龙剪水 箭拳箭腿 蝎鞭腿 轰天雷 霹雳天雷
an ian ei	万箭锥 箭拳箭腿
ian ang an	天霜拳 指点江山
ang u ian	佛光初现 佛光初现 佛光初现 佛光初现 佛光初现 电光初现 电光初现 电光初现 穹苍无边 风霜扑面
eng ang u ian	风霜扑面
an ao ve	霜寒抱月
ang an ao ve	霜寒抱月
ong ao	五龙道 冰龙冲霄 冰龙冲霄 凶暴 妖魂冲霄 恶电冲霄 梅花三弄脚 死气冲霄 聚龙抱 金钟罩 铜脚 雪泥鸿爪 霜结中霄
ie ong ao	霜结中霄
ang ie ong ao	霜结中霄
ve en ei	朱雀恨水 霜雪纷飞
ang ve en ei	霜雪纷飞
ang e	当头棒喝 霜冷长河
eng ang e	霜冷长河
ang eng ang e	霜冷长河
ei ei	刁钻诡奇龙尾腿 天网恢恢 想入非非 蝎尾腿 追悔 霜痕累累
en ei ei	霜痕累累
ang en ei ei	霜痕累累
ing ian u	蛇形电步 蛇形电步 霜凝见绌
ang ing ian u	霜凝见绌
ang o u	披霜拨露
i ang o u	披霜拨露
ve ing ang	傲雪凌霜
ao ve ing ang	傲雪凌霜
u eng	傲立孤峰 入梦 千魂屠城 畜生 金顶佛灯 金顶佛灯 金顶佛灯 金顶佛灯
i u eng	傲立孤峰
ao i u eng	傲立孤峰
vn ei	捷若迅雷 追云腿 雪岭寻梅
ing vn ei	雪岭寻梅
ve ing vn ei	雪岭寻梅
vn a ing	凌云压顶
ing vn a ing	凌云压顶
e ao ing	霜河倒影
ang e ao ing	霜河倒影
v ao ing	霜履薄冰
ang v ao ing	霜履薄冰
ie a an	铁杀拳
ve ang ong	铁血长空
ie ve ang ong	铁血长空
ve u ang	铁血无双
ie ve u ang	铁血无双
u II	九狼逐日 力在布施 恶蝠势 断虎式 法华渡世 狂狮逐日 狂麟扑噬 狮扑噬 疯狼屠狮 白骨指 碎骨指
II u II	狂狮逐日 狮扑噬
ang II u II	狂狮逐日
ang a ao	铁血狂杀道
ve ang a ao	铁血狂杀道
ou in u	兽心怒
ing ao an	五行豹拳
u ing ao an	五行豹拳
ao ou in	千豹投林 土豹投林 火烙手印 虎爪偷心
u ao ou in	土豹投林 虎爪偷心
ao ian an	火豹连环 铜炮连环
o ao ian an	火豹连环
ao ang ei	金豹双捶
in ao ang ei	金豹双捶
ve ang an	灭绝王拳 穿越光环
ie ve ang an	灭绝王拳
ie en	灭神
a u	八卦步 散手八扑 杀佛 蛇打雾 蛇打雾 魔光阳大暑
i ie an	涅槃七劫拳
an i ie an	涅槃七劫拳
ie u ang	劫无相
ou ei	亢龙有悔 亢龙有悔 亢龙有悔 亢龙有悔 亢龙有悔 亢龙有悔 亢龙有悔 亢龙有悔 劫有为
ie ou ei	劫有为
ie u ian	劫如电
an an	冰剐万斩 冰剐万斩 千劫万难 吼天战拳 少林罗汉拳 巨蟒盘缠 愁云惨淡 火龙穿山 火龙穿山 盛意拳拳 紫旋龙卷缠 铜炮穿山
o an an	少林罗汉拳
in o an an	少林罗汉拳
an ai o	罗汉拜佛
o an ai o	罗汉拜佛
ou u ai	倒叩如来
ao ou u ai	倒叩如来
o u ao	金锣普照 降魔伏妖
ang o u ao	降魔伏妖
ao o an	笑罗汉
ei o an	天雷破山 睡罗汉 醉罗汉
an ou ou	醉拳扣手
ei an ou ou	醉拳扣手
u en ao	懒佛伸腰 第十三重鬼哭神号 蚀骨春宵
an u en ao	懒佛伸腰
ei u u ian	睡佛锄奸
ian o an	天罗汉 炎火钻 癫罗汉
i ong	万劫一空 万雷齐轰 三一元气功 九幽逆经奇功 五岳齐轰 剑洗千里空 大圣门神力功 天地煞气功 天惊地动 殛空 滚地龙 滚地龙 滚地龙 滚地龙 炎阳奇功 电剑殛空 血雾迷踪 酩酊心法七重 铁骨奇功 闪电奇功 鹰旋万里空
en i ong	大圣门神力功 滚地龙 滚地龙 滚地龙 滚地龙
en en i ong	大圣门神力功
ai a	惊雷铠甲 猴王摘茄 琉璃铠甲 绝代杀 舍利铠甲 铜铠甲
ang ai a	猴王摘茄
ou ang ai a	猴王摘茄
ao ian ao	大圣朝天脚
eng ao ian ao	大圣朝天脚
ang ian ao	千浪千涛 猴王献爪
ou ang ian ao	猴王献爪
ei i	九阳归一 云踪霏迷 十阳归一 无量为一 水级 水级 烈火飞膝 神力飞膝 第二式玄武悲泣
i ei i	神力飞膝
en i ei i	神力飞膝
en ong an	崆峒神通拳
ong en ong an	崆峒神通拳
ong ian an	三通连环 元空天轉 合纵连环 火龙千转
an ong ian an	三通连环 元空天轉
ian ei o	天雷过
ing ei en	惊雷震
ing ong u u	灵龙吐珠
ao a an	凶豹杀拳 血道杀拳
ve ao a an	血道杀拳
ve ong ian	血冲天
ve ian e	血淹地
ve eng ong	血横空
a ei an	铁家雷拳
ie a ei an	铁家雷拳
ei eng ong	雷横空
ei ong an	轰天雷动拳
ian ei ong an	轰天雷动拳
ei ing en	蝎尾钉魂 雷霆震
ei en ian	雷震天
e ei ong	恶雷轰 配合任何内功
ong ei an	天关赤红内丹 波动雷拳
o ong ei an	波动雷拳
ing ou ian	雷行九天
ei ing ou ian	雷行九天
ei en an	狂雷震撼
ang ei en an	狂雷震撼
ei u ao	暴雷诛妖 碎骨爪
ao ei u ao	暴雷诛妖
ian ou ong an	千手铜拳
i a	千钧一发 霓霞
vn i a	千钧一发
ian vn i a	千钧一发
ian ei ai ian	千锤百炼
ian ang ian ao	千浪千涛
vn an a	千军万马 千军万马
ian vn an a	千军万马 千军万马
ong ao a an	凶豹杀拳
ao en ao	懒豹伸腰
an ao en ao	懒豹伸腰
ao in ang	饿豹擒狼
e ao in ang	饿豹擒狼
an in	万箭穿心 两极冰火螺旋劲 冰玄劲 归元劲 恶豹穿心 截拳劲 智拳印 毒蝎穿心 混沌螺旋劲 碎骨穿心 移阳转阴 锻筋 长生冰火螺旋劲 长生寒冰螺旋劲 长生寒冰螺旋劲 长生寒冰螺旋劲 长生烈火螺旋劲 长生烈火螺旋劲 长生烈火螺旋劲 魍魉混元劲 鹰爪穿心
ao an in	恶豹穿心 鹰爪穿心
e ao an in	恶豹穿心
ong ian ao ei	冲天豹捶
ian ao ou in	千豹投林
ong ing an	七十二路空明拳
u ong ing an	七十二路空明拳
o II u	天魔蚀骨 左右互搏之术
u o II u	左右互搏之术
ou ao an	何仙姑乱睡象牙床左右搅反 凶兽暴拳
ong ou ao an	凶兽暴拳
ie an ao	万劫难逃 五毒邪元爪 截拳道
ian ou an	千手拳
a an ei	天花乱坠 天花乱坠 天花乱坠 天花乱坠
ian a an ei	天花乱坠 天花乱坠 天花乱坠 天花乱坠
ong ou ao	凶兽道 杀龙求道 空手道
v an	四箭破巨关 棂霏玉婵 鱼跃於渊 鹰咀拳 龙跃於渊
ing v an	鹰咀拳
en ang	凤皇神罡 如来神掌 如来神掌 易天乾坤掌 浑天神掌 烈阳神掌 無量神掌 离魂掌 般若神掌 落魂桩 达摩神掌 达摩神掌 铁沙神掌 雾雰象 霹雳神掌 霹雳神掌 黯然销魂掌
ai en ang	如来神掌 如来神掌
u ai en ang	如来神掌 如来神掌
in in	一心印 一心印 冰魄麒麟劲 天鼓雷音印 天鼓雷音印
i in in	一心印 一心印 冰魄麒麟劲
o ang u ian	佛光初现 佛光初现 佛光初现 佛光初现 佛光初现
ing in	光聚佛顶印 光聚佛顶印 刻骨铭心 宝瓶印 成就一切明印 战鼓鸣金 长生寒冰劲
u ing in	光聚佛顶印 光聚佛顶印 刻骨铭心 战鼓鸣金
v u ing in	光聚佛顶印 光聚佛顶印
ing u eng	金顶佛灯 金顶佛灯 金顶佛灯 金顶佛灯
in ing u eng	金顶佛灯 金顶佛灯 金顶佛灯 金顶佛灯
en en in	不动根本印 不动根本印 不动根本印 不动根本印
ong en en in	不动根本印 不动根本印 不动根本印 不动根本印
an e	一器动山河 佛动山河 佛动山河 佛动山河 佛动山河 佛动山河 剑啸山河 怒拔山河 怒碎山河 方圆着 明暗着 电爪战车
ong an e	一器动山河 佛动山河 佛动山河 佛动山河 佛动山河 佛动山河
u ong an e	佛动山河 佛动山河 佛动山河 佛动山河 佛动山河
ei in in	天鼓雷音印 天鼓雷音印
u ei in in	天鼓雷音印 天鼓雷音印
en a an	佛问珈蓝 佛问珈蓝 佛问珈蓝 佛问珈蓝
u en a an	佛问珈蓝 佛问珈蓝 佛问珈蓝 佛问珈蓝
a en in	转法轮印 转法轮印
an a en in	转法轮印 转法轮印
u i ian	无殛电 迎佛西天 迎佛西天 迎佛西天 迎佛西天
ing u i ian	迎佛西天 迎佛西天 迎佛西天 迎佛西天
u a in	日光菩萨印
ang u a in	日光菩萨印
o ang u ao	佛光普照 佛光普照 佛光普照
ve in	金刚橛印
ang ve in	金刚橛印
in ang ve in	金刚橛印
ang II	一阳指 不灭凤凰势 八步穿阳指 回网势 大力金刚指 天佛降世 天佛降世 废寝忘食 撒网势 无弓放矢 无的放矢 浪势 神佛降世 神龙降世 结网势 翻江势 苍狼势 阴阳指 饿狼噬 魔佛降世
u ang II	天佛降世 天佛降世 魔佛降世
ian u ang II	天佛降世 天佛降世
ang in	伏妖金刚印 反荡劲 四梵无量心 摧心双印 旋风太阳劲 智吉祥印 烈阳劲 电罡劲 金刚印 金刚印 雷罡劲 风罡劲 魔血狂臨
i ang in	智吉祥印
II i ang in	智吉祥印
a u ian	佛法无边 佛法无边 佛法无边 佛法无边
o a u ian	佛法无边 佛法无边 佛法无边 佛法无边
ie ing in	成就一切明印
i ie ing in	成就一切明印
u ao ong	万佛朝宗 万佛朝宗 万佛朝宗 铁沙虎爪功
an u ao ong	万佛朝宗 万佛朝宗 万佛朝宗
ai ong	佛抱怀容 火龙在空 百发百中
ao ai ong	佛抱怀容
u ao ai ong	佛抱怀容
o ang II	神佛降世
en o ang II	神佛降世
en eng u	舍身成佛
e en eng u	舍身成佛
o en ang	落魂桩 达摩神掌 达摩神掌
a o en ang	达摩神掌 达摩神掌
ian u ang	剑无双 千毒掌 天佛掌 降魔千佛掌
o u an	大罗佛圈
a o u an	大罗佛圈
u en a	佛祖问法 天妖屠神法
o u en a	佛祖问法
ou u in	千手佛印 昂首吐信
ian ou u in	千手佛印
v i ang	大须弥掌
a v i ang	大须弥掌
eng o	万家生佛 立地成佛
i eng o	立地成佛
i i eng o	立地成佛
ei in ang	摧心掌 摧心掌
in ang in	伏妖金刚印 摧心双印 金刚印 金刚印
ei in ang in	摧心双印
in ian	心变 扣人心弦 掌心电
en in ian	扣人心弦
ou en in ian	扣人心弦
a i	上天下地 杀器 杀器 杀器 死心塌地 释法义 龙震大地
in a i	死心塌地
I in a i	死心塌地
ian an in	万箭穿心
an ian an in	万箭穿心
vn ang	排云掌 武当太极云掌 火云掌 火云掌 火云掌
o vn ang	火云掌 火云掌 火云掌
ie ong	九死邪功 九死邪功 九死邪功 四大皆空 火云铁桶 阎王令邪功 鬼打邪功
vn ie ong	火云铁桶
o vn ie ong	火云铁桶
o e u in	火蛇吐信 火蛇吐信
ong an an	火龙穿山 火龙穿山 紫旋龙卷缠
o ong an an	火龙穿山 火龙穿山
ai ing	排云摘星 火云盖顶 火云盖顶 穿云摘星 裂云摘星
vn ai ing	排云摘星 火云盖顶 火云盖顶 穿云摘星 裂云摘星
o vn ai ing	火云盖顶 火云盖顶
ai u ian	火海无边 火海无边 苦海无边
o ai u ian	火海无边 火海无边
o ao an	圣火燎原 地火燎原 地火燎原 天火燎原 离火燎原 鬼火燎原
e o ao an	地火燎原 地火燎原
o en eng	天火焚城 天火焚城 天火焚城
ian o en eng	天火焚城 天火焚城 天火焚城
ong II	火龙式
o ong II	火龙式
i en ang	离魂掌 霹雳神掌 霹雳神掌
i i en ang	霹雳神掌 霹雳神掌
ao i i	九阳小霹雳
ang ao i i	九阳小霹雳
a i i	九阳大霹雳
ang a i i	九阳大霹雳
e i	两极归元天地合一 乐艺 井中月&遁去的一 刀剑合一 刻骨折膝 双阳合璧 圣帝舍利 射艺 真言九印合一 雷电合击
ang e i	双阳合璧
ang ang e i	双阳合璧
i an ang	天地玄掌
ian i an ang	天地玄掌
ou ian i	气游天地 气游天地 龙游天地
i ou ian i	气游天地 气游天地
ing i	五行气 地转星移 斗转星移 斗转星移 虚空甯宓 裂冰劈 连环魁星踢 青气
an ing i	地转星移 斗转星移 斗转星移
ou an ing i	斗转星移 斗转星移
i an ian en	易转乾坤 逆乱乾坤 逆转乾坤
ian ang	刀罗剑网 变相 明玉绵掌 殃云天降 火翼天翔 玄阴绵掌 电掌 百孔千疮 盘丝绵掌 绝木乾罡 铁沙绵掌 闪电掌 霍电象 青城绵掌
I ian ang	盘丝绵掌
an I ian ang	盘丝绵掌
u I	天蚕吐丝
an u I	天蚕吐丝
ian an u I	天蚕吐丝
ao I	拨茧挑丝
ian ao I	拨茧挑丝
o ian ao I	拨茧挑丝
ian o ou	丝前搏后 如来千佛手
I ian o ou	丝前搏后
e en ang	般若神掌
o e en ang	般若神掌
o in	伏魔印 佛問魔心 包藏祸芯 天残破金 奇门阎罗劲 爆破劲 长生烈火劲 风火印 魔音
u o in	伏魔印
eng o in	风火印
ian in	极乐仙音 虎千斤 雷电印
ei ian in	雷电印
ing an ang	玄冰寒掌
an ing an ang	玄冰寒掌
ve ei ang	六月飞霜
ou ve ei ang	六月飞霜
ing i i	寒冰霹雳 雷霆一击
an ing i i	寒冰霹雳
eng an II	冰封三尺 冰封三尺 冰封三尺
ing eng an II	冰封三尺 冰封三尺 冰封三尺
an ing i ou	寒冰霹球
o ao	云海波涛 修罗道 刻骨破脑 唯我道 大天魔刀 天魔刀 小天魔刀 破脑 神火道 裂头破脑 轉心魔道 魔招 龙形摩桥
en o ao	神火道
in ei	动心雷 掌心雷 摧心锥 杀心雷 破日金锥
ang in ei	掌心雷
o u i	呆若木鸡 圣火护体 梵我如一 神火护体
en o u i	神火护体
ou ong ei	炙手轰雷 百兽同悲
II ou ong ei	炙手轰雷
ong e	冰天冻地 笔走龙蛇 轻重着 雷火动地
o ong e	雷火动地
ei o ong e	雷火动地
ei ei ong	千雷归宗
ian ei ei ong	千雷归宗
a en ang	铁沙神掌
ie a en ang	铁沙神掌
ou ei an	铁牛推山
ie ou ei an	铁牛推山
ang en in	大金刚轮印 铁掌分金
ie ang en in	铁掌分金
ie i ong ang	铁臂铜墙
a en eng	万马奔腾 万马奔腾 铁沙焚城
ie a en eng	铁沙焚城
a ian ang	铁沙绵掌
ie a ian ang	铁沙绵掌
ie ou	乾坤转业手 庖丁解牛 招魂铁手 招魂铁手
en ie ou	招魂铁手 招魂铁手
ao en ie ou	招魂铁手 招魂铁手
ai vn ang	排云掌
ing vn	流水行云 流水行云 紫宫高处入青云
ei ing vn	流水行云 流水行云
ou ei ing vn	流水行云 流水行云
ai ve	披云戴月 神脉诀 翻海诀
vn ai ve	披云戴月
i vn ai ve	披云戴月
vn u v	翻云覆雨 翻云覆雨 翻云覆雨
an vn u v	翻云覆雨 翻云覆雨 翻云覆雨
ao ai	排山倒海 排山倒海 排山倒海 排山倒海
an ao ai	排山倒海 排山倒海 排山倒海 排山倒海
ai an ao ai	排山倒海 排山倒海 排山倒海 排山倒海
i II	乌云蔽日 以卵击石 倒行逆施 倒行逆施 完美一式 开山劈石 灵犀一指 灵犀一指 紫焰七势 虹墙蔽日 锋寒七式 霸腿七式
vn i II	乌云蔽日
u vn i II	乌云蔽日
en o	刁魂破 地心真火 重云深锁
vn en o	重云深锁
ong vn en o	重云深锁
ai vn	撕天排云
ian ai vn	撕天排云
I ian ai vn	撕天排云
ai o ao	云海波涛
vn ai o ao	云海波涛
vn u ing	变云无定
ian vn u ing	变云无定
vn ian ang	殃云天降
ang vn ian ang	殃云天降
ian ing	云莱仙境 六箭碎天灵 如意天经 怒碎天灵
ai ian ing	云莱仙境
vn ai ian ing	云莱仙境
vn an an	愁云惨淡
ou vn an an	愁云惨淡
ei ing	云踪魅影 天残蝎尾钉 如影随形 悲鸣 无定飞星 追影 雷霆 驭电追星
ong ei ing	云踪魅影
vn ong ei ing	云踪魅影
eng ian ang	青城绵掌
ing eng ian ang	青城绵掌
en II	一刹神之 三分神指 五转分尸 冥爪分尸 啄肉分尸 大鹰振翅 太玄神指 封神式 恶龙吞日 茧困势 问势 鲸吞势
vn II	云势
vn u	踪云步 风急云怒
ong vn u	踪云步
ian en ang	易天乾坤掌 浑天神掌
en ian en ang	浑天神掌
vn ian	白云剑 白云烟 白云烟 过眼云烟
ai vn ian	白云剑 白云烟 白云烟
a ang	两仪八卦掌 五行八卦掌 八卦掌 四转八方 天罗杀网 春雷乍響 玫霞荡 玫霞荡 硃砂掌 离火七煞掌 赤煞掌 降龙十八掌 降龙十八掌 降龙十八掌 降龙十八掌 降龙十八掌 降龙十八掌 霓霞象 飞莲踏浪
ei a ang	春雷乍響 玫霞荡 玫霞荡
en en	乾坤身 土昆仑 土昆仑 天魔分身 悲天刎人 玄混沌 阴阳混沌
u en en	土昆仑 土昆仑
ve ing	碧雪冰 碧雪冰 绝情
i ve ing	碧雪冰 碧雪冰
ing e	动静着 回转星河 紫星河 紫星河
I ing e	紫星河 紫星河
ang ang	五轮金刚掌 冰河莽莽 冰河莽莽 冰火螳螂 天罡掌 密宗金刚掌 少林金刚掌 弥勒降殃 星火相撞 纯阳掌 菩提树下啖黃汤 血气方刚 阎王掌 鬼影幢幢
in ang ang	五轮金刚掌 密宗金刚掌 少林金刚掌
en in ang ang	五轮金刚掌
o ing	云龙破岭 云龙破岭 坎雷过岭 夜叉索命 天雷破岭 婆罗魔经 平步登天任我行 捕风捉影 捕风捉影 捕风捉影 潜麟过岭 电光破岭 第七重恶鬼索命 血火鼎 金杨破岭 饮恨魔经 黑绝魔经
ei o ing	坎雷过岭 天雷破岭 第七重恶鬼索命
ian ei o ing	天雷破岭
ian eng ong	云现风涌 殛电横空 雷电横空 雷电横空
i ian eng ong	殛电横空
ao eng	九重阙三焦生 旋转暴风 颷风
an ao eng	九重阙三焦生 旋转暴风
an an ao eng	旋转暴风
ao ian	天外逍遥篇 怒海啸天 恶浪滔天 曹国舅云阳见板左右颠倒颠 朝阳耀天 水兮滔天 洪荒浩焰 浑天宝鉴 玄阴宝鉴 白虎啸天 离火燎天 韩湘子萧声响亮便把蟠桃献 饿狼哮天 饿狼啸天
ai ao ian	怒海啸天
u ai ao ian	怒海啸天
ve ang	阳世五绝掌
u ve ang	阳世五绝掌
II u ve ang	阳世五绝掌
an a ao	阳关大道
ang an a ao	阳关大道
i an	不死七幻 元阳闭关 共工移川 天地斩 天愁地惨 如意七转 如意禅 愚公移山 星河气旋 气关 绝息关 雷神疾旋 雷神疾闪 青鉴秘卷 龙卷气旋
ang i an	元阳闭关
an ang i an	元阳闭关
i ai	三阳启泰 九阳启泰 五箭伤气海 地极气海 地脉 天极气海 無量氣海 突如其来 突如其来 麻鹰捉鸡仔
ang i ai	三阳启泰 九阳启泰 五箭伤气海 無量氣海
an ang i ai	三阳启泰
in ao ang	颠阴倒阳
ian in ao ang	颠阴倒阳
ang an in	移阳转阴
i ang an in	移阳转阴
ang ong ang	二十三式降龙掌 八方龙王 十七式降龙掌
II ang ong ang	二十三式降龙掌 十七式降龙掌
ong ou ei	亢龙有悔 亢龙有悔 亢龙有悔 亢龙有悔 亢龙有悔 亢龙有悔 亢龙有悔 亢龙有悔
ang ong ou ei	亢龙有悔 亢龙有悔 亢龙有悔 亢龙有悔 亢龙有悔 亢龙有悔 亢龙有悔 亢龙有悔
ong ai ian	见龙在田 见龙在田 见龙在田 见龙在田 见龙在田 见龙在田 见龙在田 见龙在田 见龙在田 飞龙在天 飞龙在天 飞龙在天 飞龙在天 飞龙在天 飞龙在天 飞龙在天
ei ong ai ian	飞龙在天 飞龙在天 飞龙在天 飞龙在天 飞龙在天 飞龙在天 飞龙在天
ong ai ie	战龙在野 战龙在野 战龙在野 战龙在野 战龙在野
an ong ai ie	战龙在野 战龙在野 战龙在野 战龙在野 战龙在野
ong u ong	潜龙勿用 潜龙勿用 潜龙勿用 潜龙勿用 潜龙勿用 青龍出洞 青龙出洞 青龙出洞 青龙出洞 青龙出洞 青龙出洞 青龙出洞 青龙出洞
ian ong u ong	潜龙勿用 潜龙勿用 潜龙勿用 潜龙勿用 潜龙勿用
ve ai an	东岳泰山 或跃在渊 或跃在渊 或跃在渊 或跃在渊 或跃在渊 或跃在渊 龙跃在渊
o ve ai an	或跃在渊 或跃在渊 或跃在渊 或跃在渊 或跃在渊 或跃在渊
en ong ai ei	神龙摆尾 神龙摆尾 神龙摆尾 神龙摆尾 神龙摆尾 神龙摆尾 神龙摆尾 神龙摆尾 神龙摆尾 神龙摆尾 神龙摆尾
ian ong ai ian	见龙在田 见龙在田 见龙在田 见龙在田 见龙在田 见龙在田 见龙在田 见龙在田 见龙在田
an u	天蚕缚 天魔乱舞 惨无 无尽乱舞 火凤乱舞 狂风乱舞 狂龙乱舞 狂龙乱舞 群鹰乱扑 群龙乱舞 群龙乱舞 群龙乱舞 群龙乱舞 群龙乱舞 群龙乱舞 苣兰芟锄 邪魔乱舞 金龙乱舞
ong an u	狂龙乱舞 狂龙乱舞 群龙乱舞 群龙乱舞 群龙乱舞 群龙乱舞 群龙乱舞 群龙乱舞 金龙乱舞
vn ong an u	群龙乱舞 群龙乱舞 群龙乱舞 群龙乱舞 群龙乱舞 群龙乱舞
ong o ai	蛟龙过海
ao ong o ai	蛟龙过海
ou en ong	左右神龙 左右神龙 左右神龙 左右神龙
o ou en ong	左右神龙 左右神龙 左右神龙 左右神龙
ai ou ian	龙在九天 龙在九天 龙在九天 龙在九天 龙在九天 龙在九天 龙在九天 龙在九天
ong ai ou ian	龙在九天 龙在九天 龙在九天 龙在九天 龙在九天 龙在九天 龙在九天 龙在九天
ong ou in	黑龙偷心 黑龙偷心 黑龙偷心 黑龙偷心 黑龙偷心 黑龙偷心
ei ong ou in	黑龙偷心 黑龙偷心 黑龙偷心 黑龙偷心 黑龙偷心 黑龙偷心
e ong an	恶龙缠 恶龙缠 恶龙缠 恶龙缠 恶龙缠 恶龙缠
er ong eng u	二龙争珠 二龙争珠 二龙争珠 二龙争珠
ing ong u ong	青龍出洞 青龙出洞 青龙出洞 青龙出洞 青龙出洞 青龙出洞 青龙出洞 青龙出洞
ang u	何仙姑弹腰献酒醉荡步 白龙挡路 白龙挡路 蛇行蟒伏 风雨江湖
ong ang u	白龙挡路 白龙挡路
ai ong ang u	白龙挡路 白龙挡路
ing ang ong	易经降龙 火精当空
i ing ang ong	易经降龙
ong a ing	飞龙压顶 飞龙压顶 飞龙压顶
ei ong a ing	飞龙压顶 飞龙压顶 飞龙压顶
ong en ao	懒龙伸腰
an ong en ao	懒龙伸腰
ong ai ong	火龙在空
o ong ai ong	火龙在空
eng en	一念成仁 冰玄成盾 冰玄成盾 天残大风轮 天残小风轮 缩龙成寸 缩龙成寸 缩龙成寸 缩龙成寸 缩龙成寸 霹雳猛震
ong eng en	缩龙成寸 缩龙成寸 缩龙成寸 缩龙成寸 缩龙成寸
o ong eng en	缩龙成寸 缩龙成寸 缩龙成寸 缩龙成寸 缩龙成寸
ong u ing	幻龙无影 幻龙无影
an ong u ing	幻龙无影 幻龙无影
ie ong ian	铁龙剪 铁龙剪
ong o ing	云龙破岭 云龙破岭
vn ong o ing	云龙破岭 云龙破岭
ong an ang	蛟龙翻江 蛟龙翻江 蟠龙翻江 蟠龙翻江
an ong an ang	蟠龙翻江 蟠龙翻江
ian ong o	天龙锁 天龙锁 天龙锁 天龙锁
an eng	无间转生 泰山崩 龙卷风 龙卷风 龙卷风 龙卷风
ong an eng	龙卷风 龙卷风 龙卷风 龙卷风
e ong eng u	饿龙争珠 饿龙争珠
ou ong i ei	游龙戏水 游龙戏水
u ong an	毒龙钻 毒龙钻 电光毒龙钻 电光毒龙钻 电光毒龙钻 箭腿毒龙钻
II a ang	赤煞掌 降龙十八掌 降龙十八掌 降龙十八掌 降龙十八掌 降龙十八掌 降龙十八掌
ong II a ang	降龙十八掌 降龙十八掌 降龙十八掌 降龙十八掌 降龙十八掌 降龙十八掌
u i ai	突如其来 突如其来
u u i ai	突如其来 突如其来
v ei	双龙取水 双龙取水
ong v ei	双龙取水 双龙取水
ang ong v ei	双龙取水 双龙取水
i e a an	利涉大川 利涉大川
ian v u	鸿渐于陆 鸿渐於陆 鸿渐於陆
ong ian v u	鸿渐于陆 鸿渐於陆 鸿渐於陆
ang ong an u	狂龙乱舞 狂龙乱舞
ong ou ian i	龙游天地
ao ong an ang	蛟龙翻江 蛟龙翻江
ing II	夜鹰势 履霜冰至 履霜冰至 履霜冰至 幻影式 恶鬼凌迟 深恶痛绝罪凌迟 虎口凌迟 邪血凌迟
ang ing II	履霜冰至 履霜冰至 履霜冰至
v ang ing II	履霜冰至 履霜冰至 履霜冰至
ou ong	时乘六龙 时乘六龙 蛇步游踪 铜头功 鱼影游踪
eng ou ong	时乘六龙 时乘六龙
II eng ou ong	时乘六龙 时乘六龙
eng u ve	龙胜五岳
ong eng u ve	龙胜五岳
ong ang II	无弓放矢 神龙降世
en ong ang II	神龙降世
ong u	徘徊空谷 游龙步 炼狱烘炉 飞纵术
ou ong u	游龙步
ve v an	鱼跃於渊 龙跃於渊
ong ve v an	龙跃於渊
ong ang ei	盘龙双飞 蟠龙双飞 蟠龙双飞 蟠龙双飞
an ong ang ei	盘龙双飞 蟠龙双飞 蟠龙双飞 蟠龙双飞
ong in an	蛟龙临渊
ao ong in an	蛟龙临渊
a ang ong ang	八方龙王
ong en II	恶龙吞日
e ong en II	恶龙吞日
ong in	力不从心 千乘万骑汹涌临 归空印 泽里龙吟 烈火攻心 煮铁融金 野豹冲林
i ong in	泽里龙吟
e i ong in	泽里龙吟
ong ve ai an	东岳泰山 龙跃在渊
ong e a an	龙涉大川
ong ao an i	龙啸万里 龙啸万里
ong u ou	群龙无首 群龙无首
vn ong u ou	群龙无首 群龙无首
ong u i	云龙无际 红菩提
vn ong u i	云龙无际
ian ian	烽火连天 焮天焰 终日乾乾 终日乾乾 终日乾乾 终日乾乾 终日乾乾 邪意绵绵 风雨莲天
II ian ian	终日乾乾 终日乾乾 终日乾乾 终日乾乾 终日乾乾
ong II ian ian	终日乾乾 终日乾乾 终日乾乾 终日乾乾 终日乾乾
II e	望梅止渴 虚实着 雷电噬嗑
ian II e	雷电噬嗑
ei ian II e	雷电噬嗑
v ie	万神俱灭 十方俱灭 龙战于野 龙战於野
an v ie	龙战于野 龙战於野
ong an v ie	龙战于野 龙战於野
ai i	震惊百里 震惊百里
ing ai i	震惊百里 震惊百里
en ing ai i	震惊百里 震惊百里
u vn	密雨不云
v u vn	密雨不云
i v u vn	密雨不云
ou u	损则有孚 罗汉叩佛 西天求渡
e ou u	损则有孚
en e ou u	损则有孚
ang u an	烈阳毒拳 羝羊触藩
i ang u an	羝羊触藩
v ve v an	鱼跃於渊
ong II II	盘龙蚀日
an ong II II	盘龙蚀日
an i an	龙卷气旋
ong an i an	龙卷气旋
en a i	龙震大地
ong en a i	龙震大地
ong a ian i	龙跨千里
in ong	五爪金龙 八方擒龙 末日隐空 毒爪擒龙 电网擒龙 金刚擒龙 铁手擒龙
ang in ong	八方擒龙 电网擒龙 金刚擒龙
a ang in ong	八方擒龙
ong ian ei	双龙剪水 双龙剪水 神龙剪水 轰天雷
en ong ian ei	神龙剪水
an ai ie	龙战在野
ong an ai ie	龙战在野
o ong u u	火龙吐珠 火龙吐珠
ao en ang	黯然销魂掌
an ao en ang	黯然销魂掌
eng ou	无中生有 晶灵圣手 毒蝎封喉 锁颈封喉 鹰爪封喉
ong eng ou	无中生有
u ong eng ou	无中生有
II ing	天魔蚀经 孤形只影
ing II ing	孤形只影
u ing II ing	孤形只影
en e	面无人色
u en e	面无人色
ian u en e	面无人色
u ei ei	想入非非
ang u ei ei	想入非非
ai ong u	徘徊空谷
ai ai ong u	徘徊空谷
in ing ou ao	心惊肉跳
i en ou ian	杞人忧天
i ai ei	拖泥带水
o i ai ei	拖泥带水
u ong in	力不从心
i u ong in	力不从心
II ou ou	行尸走肉
ing II ou ou	行尸走肉
u o u	穷途末路
ong u o u	穷途末路
ing i II	倒行逆施 倒行逆施
ao ing i II	倒行逆施 倒行逆施
I ao	庸人自扰
en I ao	庸人自扰
ong en I ao	庸人自扰
in ang II	大力金刚指 废寝忘食 阴阳指
ei in ang II	废寝忘食
en en eng	饮恨吞声
in en en eng	饮恨吞声
ai o u i	呆若木鸡
en u an	六神不安
ou en u an	六神不安
ou e	三转六合 将军抽车 神不守舍 神不守舍 魂不守舍
u ou e	神不守舍 神不守舍 魂不守舍
en u ou e	神不守舍 神不守舍 魂不守舍
ou o II	修罗指 若有所失
o ou o II	若有所失
en ang a	销魂掌法
ao en ang a	销魂掌法
an v	疯噬幻狱 碎金断玉 缘来缘去 罗汉御 雷霆战躯
ai an v	缘来缘去
an ai an v	缘来缘去
ao i e	天造地设
ian ao i e	天造地设
ing ang ei	蝶影双飞
ie ing ang ei	蝶影双飞
ing ie ang	有影皆双
ou ing ie ang	有影皆双
” ang	三“云十”掌
II ” ang	三“云十”掌
vn II ” ang	三“云十”掌
ing u in	雷霆无尽
ei ing u in	雷霆无尽
o u ian	风火无边
eng o u ian	风火无边
ing u i	五情无敌
u ing u i	五情无敌
u an ang	哭断肠 百步穿扬 苦难掌
ai u a	气海无涯 火海无涯 苦海无涯 血海无涯
u ai u a	苦海无涯
u ong eng	普渡众生 普渡众生 百毒纵横 魔渡眾生
u u ong eng	普渡众生 普渡众生
ou ang e	当头棒喝
ang ou ang e	当头棒喝
ing u en	明镜拂尘
ing ing u en	明镜拂尘
a ie ong	四大皆空 鬼打邪功
I a ie ong	四大皆空
u en ong	暮鼓晨钟
u u en ong	暮鼓晨钟
i u u	七级浮屠 易筋经七级浮屠 白级浮屠 白级浮屠 紫级浮屠 红级浮屠 红级浮屠 蓝级浮屠 蓝级浮屠 青级浮屠 黄级浮屠 黄级浮屠 黑级浮屠 黑级浮屠
i i u u	七级浮屠 易筋经七级浮屠
ang en ang	凤皇神罡 烈阳神掌 無量神掌
u ang en ang	無量神掌
u ang i ai	無量氣海
ao u ang	狂濤無量 迷窍毒掌 驚濤無量
ang ao u ang	狂濤無量
ong u ang	狂龍無量
ang ong u ang	狂龍無量
ai u ang	大海無量
a ai u ang	大海無量
ing ao u ang	驚濤無量
i en	無量殛震 盘古天殛震 破雷殛震 醉一分——大醉七分 雷霆殛震
ang i en	無量殛震
u ang i en	無量殛震
II ao	九阴寒尸爪 断肢道 断肢道 無量直搗 破头蚀脑 碎石脚
ang II ao	無量直搗
u ang II ao	無量直搗
ang a ian	海網撒天
ai ang a ian	海網撒天
an ai an	千漩百轉
ian an ai an	千漩百轉
ang ang an	海量汪涵 狂狼斩
ai ang ang an	海量汪涵
ie i	天魔解体 無量迭起 转世业力 金刚解肌
ang ie i	無量迭起 金刚解肌
u ang ie i	無量迭起
a ong	浪濤沙蹤 霸靇
ao a ong	浪濤沙蹤
ang ao a ong	浪濤沙蹤
eng ang a	邪风掌法
ie eng ang a	邪风掌法
ai en	双鬼拍门 铁拐李旋肘膝撞醉还真 阴差拍门 鬼王拍门
ang ai en	鬼王拍门
ei ang ai en	鬼王拍门
o an u	天魔乱舞 邪魔乱舞
ie o an u	邪魔乱舞
u i an	如意禅
ong ai	佛我同在 紫气东来 魔從中來
o ong ai	佛我同在
u o ong ai	佛我同在
ei II	万法唯识 冰火碎尸 悉所不能。一念沛之 火龙追日 百鬼碎尸 破雷势 追日 追逝 问雷式
a ei II	万法唯识
an a ei II	万法唯识
II v ong	大日虚空
a II v ong	大日虚空
ang ei i	九阳归一 十阳归一 无量为一
u ang ei i	无量为一
an en	两极三问 乱魂 六道战神 冤鬼缠身 分尸散魂 千雷万震 如意禅震 小梵天禅震 魔狼战身
i an en	两极三问 如意禅震
u i an en	如意禅震
ong ang i	白虹掌力
ai ong ang i	白虹掌力
ong an II	千虫万噬 双虹贯日 白虹贯日
ai ong an II	白虹贯日
ong en ian	火虹焚天 火龙吞天 火龙吞天
o ong en ian	火虹焚天 火龙吞天 火龙吞天
ong an ou	惊虹断流 破空元手 空元手
ing ong an ou	惊虹断流
ang i II	虹墙蔽日
ong ang i II	虹墙蔽日
ie e	天魔裂地 无环裂地 水银泻地 电网泻地 虹光泻地
ang ie e	电网泻地 虹光泻地
ong ang ie e	虹光泻地
ong u ian	採虹补天 火龙初现 火龙初现
ai ong u ian	採虹补天
ie ang en ang	烈阳神掌
ian an vn	日燄捲雲 火箭穿云 金剑穿云
II ian an vn	日燄捲雲
ong ai II	火龙拜日
o ong ai II	火龙拜日
ang u i	燁阳不息 紫阳无极 黄菩提
ie ang u i	燁阳不息
vn an i	火云万里
o vn an i	火云万里
ang i i	烈阳霹雳 阴阳两极气
ie ang i i	烈阳霹雳
ve an ang	银月幻掌
in ve an ang	银月幻掌
ou o	修罗 冥府修罗 天降修罗 月營流梭 神鹰九夺
ing ou o	月營流梭 神鹰九夺
ve ing ou o	月營流梭
en ong ong	月魂憧憧
ve en ong ong	月魂憧憧
in u en an	银弧寸断
ao ao	刀章妙炒 古今自逍遥 怒月暴潮 青涛啸
ve ao ao	怒月暴潮
u ve ao ao	怒月暴潮
ve o	星隕月落
vn ve o	星隕月落
ing vn ve o	星隕月落
a II II	白华蚀日
ai a II II	白华蚀日
ve u a	银月无华
in ve u a	银月无华
o i ang	天罗地网
ian o i ang	天罗地网
o ian o	左天罗
ang ou o	天降修罗
ian ang ou o	天降修罗
i ian o	紫气天罗 紫气天罗 紫气天罗 逆天破
I i ian o	紫气天罗 紫气天罗 紫气天罗
e ang	右地网 邪风可长
ou e ang	右地网
ang an ian	地网翻天 狂狼斩天
e ang an ian	地网翻天
ie ang II	结网势
a ang II	撒网势
ei ang II	回网势
o an ang	千罗万网 千罗万网
ian o an ang	千罗万网 千罗万网
ian ao II	雷电交织 雷电交织
ei ian ao II	雷电交织 雷电交织
a a ang	两仪八卦掌 五行八卦掌 八卦掌
ing a a ang	五行八卦掌
i a a ang	两仪八卦掌
i ang ao	火里藏刀 绵里藏刀
ian i ang ao	绵里藏刀
ai ai	否极泰来 否极泰来
i ai ai	否极泰来 否极泰来
i i ai ai	否极泰来 否极泰来
an ang i	反两仪 地霸气诀之阴阳玄刚气
eng ang i	正两仪
ang ang i i	阴阳两极气
i a ang	离火七煞掌 霓霞象
o i a ang	离火七煞掌
ing ian	一火擎天 冰柱擎天 四灵剑 天行健 青焰
o ing ian	一火擎天
i o ing ian	一火擎天
o i ang ao	火里藏刀
i o ao an	离火燎原
i o ei	肢离火碎
II i o ei	肢离火碎
v en	五脏俱焚 玉石俱焚 香销玉损
ang v en	五脏俱焚
u ang v en	五脏俱焚
eng ei	六神成灰 日月争辉 血肉横飞
en eng ei	六神成灰
ou en eng ei	六神成灰
en an ian	千焚萬炼 曦轮万千
ian en an ian	千焚萬炼
e ian	只手遮天 大泽剑 少泽剑 少泽剑 惊雷恶电 星河剑 毒蝎车鞭
ou e ian	只手遮天
II ou e ian	只手遮天
an ei o ing	坎雷过岭
ou eng an	左右逢源
o ou eng an	左右逢源
a ang a	人煞掌法 玄卦挡煞
an a ang a	玄卦挡煞
an ang a	天残掌法
ian an ang a	天残掌法
ve II	天残缺日 天鹰攫日 牙刃血指
an ve II	天残缺日
ian an ve II	天残缺日
ve ve	天残缺月 明月诀 明月诀
an ve ve	天残缺月
ian an ve ve	天残缺月
an II II	天残蚀日
ian an II II	天残蚀日
ve ian an	日月天残
II ve ian an	日月天残
ve ang a	地缺掌法
e ve ang a	地缺掌法
eng vn	六道万行御风云 动风云 纷纷扰扰断风云 蛟腾云
ao eng vn	蛟腾云
e a u	蛇打雾 蛇打雾
ao u ian	豹逐电
en a ang a	人煞掌法
in v ve	伤心欲绝
ang in v ve	伤心欲绝
o u ang	搜索枯肠 搜索枯肠
ou o u ang	搜索枯肠 搜索枯肠
v ian ang	明玉绵掌
ing v ian ang	明玉绵掌
i ian ian	邪意绵绵
ie i ian ian	邪意绵绵
ai eng	十级台风 涅磐再生 荡夷歪风 邪气歪风
i ai eng	十级台风 荡夷歪风 邪气歪风
ie i ai eng	邪气歪风
u ie ang	无邪掌
eng e ang	邪风可长
ie eng e ang	邪风可长
ie ai	六业衰 否极邪来
i ie ai	否极邪来
ou i ie ai	否极邪来
i ao u ang	迷窍毒掌
ang en ou	断肠温柔
an ang en ou	断肠温柔
in en i	先天纯阴真气 痴心魂离 金晨曦
II in en i	痴心魂离
i eng	和氏璧异能 和氏璧异能 和氏璧异能 和氏璧异能 和氏璧异能 太极封 荡魄绮梦
o i eng	荡魄绮梦
ang o i eng	荡魄绮梦
II u en ao	蚀骨春宵
e u ong	毒蛇出洞 配合毒功 配合毒功 配合毒功
ei e u ong	配合毒功 配合毒功 配合毒功
ong in u	阴阳邪毒功阴毒
u ong in u	阴阳邪毒功阴毒
ian eng	佛点千灯 奈何桥上忘前生 风起云涌毒锁千峰
o ian eng	风起云涌毒锁千峰
u o ian eng	风起云涌毒锁千峰
in ing	千毒绝心经 易筋经 汉钟醉步抱坛窝心顶
ve in ing	千毒绝心经
u ve in ing	千毒绝心经
e en a	配合身法 配合身法 配合身法 配合身法 配合身法
ei e en a	配合身法 配合身法 配合身法 配合身法 配合身法
ian en a	一缕轻烟身法
ing ian en a	一缕轻烟身法
i vn ang	武当太极云掌
ai i vn ang	武当太极云掌
an vn ai ing	穿云摘星
ai v	云游太虚
ou ai v	云游太虚
vn ou ai v	云游太虚
a a u	八卦步
in ian a	君临天下 鹰临天下
ing in ian a	鹰临天下
ing o	怒鹰啄
u ing o	怒鹰啄
ing u u	雄鹰扑兔 飞鹰扑兔 饿鹰扑兔
e ing u u	饿鹰扑兔
ing o II	残鹰落日 神鹰破日 群鹰夺食
vn ing o II	群鹰夺食
ou vn	形影流云 电流云
ian ou vn	电流云
ang in ian	掌心电
ao ao ang	张果老倒骑毛驴摔在高桥上 逍遥掌
ian ong ve	双仙拱月
ang ian ong ve	双仙拱月
an ian ang	闪电掌
ing ong	剑傲英雄 双蝎行空 天马行空 无影鹰踪 无影鹰踪 玄冰功 疾电惊虹 离火玄冰功 逆浪行凶 配合轻功
ian ing ong	疾电惊虹
i ian ing ong	疾电惊虹
I ang	傲啸四方 傲啸风云我自王 净土慈航 四阳 次阳 火舞骄阳照四方 金丝掌
in I ang	金丝掌
i en en ou	黄天当立震神州
ong ang a	劈空掌法
i ong ang a	劈空掌法
ong an vn	裂空断云 龙翻云
ie ong an vn	裂空断云
in u i	离心独劈 金菩提 银菩提
i in u i	离心独劈
in ian ang	玄阴绵掌
an in ian ang	玄阴绵掌
I u ou	丝丝入扣
I I u ou	丝丝入扣
i ei an	紫气归元 荡气回旋
ang i ei an	荡气回旋
ian ang ang	天罡掌 阎王掌
in in ang ang	少林金刚掌
u o	伏妖除魔 力贯万斤象步堕 无恨无我 逆天無我 金刚伏魔
ao u o	伏妖除魔
u ao u o	伏妖除魔
ang a an	横扫千军象拔拳 金刚下凡
in ang a an	金刚下凡
ian ou ang	百毒千手掌
u ian ou ang	百毒千手掌
ong an ong	毒虫钻洞
u ong an ong	毒虫钻洞
ian ong an II	千虫万噬
o ang	兴风作浪 大天魔场 小天魔场 杀破狼 狱火掌 金鳞破浪
v o ang	狱火掌
ian ian o	紫电天罗
I ian ian o	紫电天罗
en I ian	气吞紫电
i en I ian	气吞紫电
ai an ang	开山掌
u a ang	硃砂掌
ian ian en ang	易天乾坤掌
ian ou in	九字真言手印 大黑天手印
en ian ou in	九字真言手印
in ang en in	大金刚轮印
I in	内狮子印 外狮子印 撕心 狮子印 繁花似锦
II I in	内狮子印 外狮子印 狮子印
ai II I in	外狮子印
ei II I in	内狮子印
ai u in	外缚印
ei u in	内缚印 碎骨劲
II an in	智拳印
II en in	大日轮印 日轮印
ao ing in	宝瓶印
in e i	真言九印合一
ou in e i	真言九印合一
ei an ou	推山手
ing ai an	五丁开山
u ing ai an	五丁开山
ong i an	共工移川 愚公移山
v ong i an	愚公移山
a in ei	杀心雷
in eng u	杀心成佛
a in eng u	杀心成佛
in ao	佛动心摇 刻骨铭心爪 劫心爪 左右金桥
ong in ao	佛动心摇
u ong in ao	佛动心摇
e I ian	杀地撕天
a e I ian	杀地撕天
ian an ou	天禅手
vn eng II	赤云封日
II vn eng II	赤云封日
i ie	一灭 储电护体阶 天诛地灭 火网提鳖 雷震劈邪
ang i ie	火网提鳖
o ang i ie	火网提鳖
o an ou	烈火断头 破元手
ie o an ou	烈火断头
en ian i	拒人千里
v en ian i	拒人千里
ang ei ei	天网恢恢
ian ang ei ei	天网恢恢
u u ing ou	百足无影手
ao o	巧取豪夺 挑拨 神龙现爪诛妖魔 蓝采和单提敬酒拦腰破
v ao o	巧取豪夺
ao v ao o	巧取豪夺
o ao II	本末倒置
en o ao II	本末倒置
ai vn ai ing	排云摘星
ian u i	翻天覆地
an ian u i	翻天覆地
ie ai ou	七箭截脉手 探花截脉手
a ie ai ou	探花截脉手
ei II e	望梅止渴
ang ei II e	望梅止渴
eng ian en	闻风先遁
en eng ian en	闻风先遁
v ang	问道于盲
ao v ang	问道于盲
en ao v ang	问道于盲
ou i i	切肉离皮 裂头霹雳
ie ou i i	切肉离皮 裂头霹雳
ai ian o ou	如来千佛手
a ing en	转法经轮 转法经轮
an a ing en	转法经轮 转法经轮
ian ian eng	佛点千灯
u ian ian eng	佛点千灯
ang ao II	佛光耀世
o ang ao II	佛光耀世
a eng o	万家生佛
an a eng o	万家生佛
an ie ou	乾坤转业手
en an ie ou	乾坤转业手
o ang eng	因果相承
in o ang eng	因果相承
an ie	缘起缘灭
i an ie	缘起缘灭
an i an ie	缘起缘灭
ang ing	佛心双明
in ang ing	佛心双明
u in ang ing	佛心双明
II ie i	转世业力
an II ie i	转世业力
a en ou	五绝杀神手
ve a en ou	五绝杀神手
u an ve	折骨断绝
e u an ve	折骨断绝
in a ve	赶尽杀绝
an in a ve	赶尽杀绝
e ong ve	心恶痛绝
in e ong ve	心恶痛绝
ie ve	三界灭绝 神亡灭绝 罗汉卸岳
ang ie ve	神亡灭绝
en ang ie ve	神亡灭绝
an an ve	人寰惨绝 天残三绝
en an an ve	人寰惨绝
ve ou	烈元绝手 碎天絕手 魔鬼四绝手
I ve ou	魔鬼四绝手
ei I ve ou	魔鬼四绝手
ou ian an	惨绝人寰扣连环
an ou ian an	惨绝人寰扣连环
eng i	绝子绝孙绝生机
ve eng i	绝子绝孙绝生机
en ve eng i	绝子绝孙绝生机
ei ing II	恶鬼凌迟 深恶痛绝罪凌迟
ve ei ing II	深恶痛绝罪凌迟
II ang	冰封十丈 冰封十丈 器绝十方 抱酲鎮十方 绝天绝地绝十方
ve II ang	器绝十方 绝天绝地绝十方
i ve II ang	器绝十方 绝天绝地绝十方
a i ou	五雷化殛手 断筋破骨大劈手 观空大劈手
u a i ou	断筋破骨大劈手
a o an	怒打罗汉
u a o an	怒打罗汉
ai ei in	如来摧心
u ai ei in	如来摧心
an u ian	九转珠连
ou an u ian	九转珠连
e ang ang	冰河莽莽 冰河莽莽 弥勒降殃
i e ang ang	弥勒降殃
o ong an ou	破空元手
ei i en	破雷殛震 醉一分——大醉七分
o ei i en	破雷殛震
an o II	天残破石 空元破日
ong an o II	空元破日
ong u ie	空空如也
ong ong u ie	空空如也
ai II ve	空懷日月
ong ai II ve	空懷日月
o ve	二雷破岳 五雷破岳 沉元破月 神州伏魔诀 紫旋破岳 般若伏魔诀 飞虎破嶽
an o ve	沉元破月 紫旋破岳
en an o ve	沉元破月
o ong	凶兽魔功 千蛇破洞 天魔功 沉空破空 离火功 荧火轰 达摩功 铁拳破空 铁索锁龙 雷霆魔功 雷霆魔功 黑煞魔功
ong o ong	沉空破空
en ong o ong	沉空破空
an i i	三元及第 混元七殛
en an i i	混元七殛
o ei II	冰火碎尸 破雷势
an ang II	八步穿阳指 翻江势
ong in ei	动心雷
i ian II	疾电势 疾电式
ei ong ang	碎穹苍 血归穹苍
ian en i	天魂殛
ing o ao	龙形摩桥
ong ing o ao	龙形摩桥
ou in ao	左右金桥
o ou in ao	左右金桥
in ong an u	金龙乱舞
vn ian en	桥运乾坤
ao vn ian en	桥运乾坤
ao a ing	铁桥八形
ie ao a ing	铁桥八形
ing ao ang	凤鸣朝阳 灵霄象 鹰翱翔
u ve ian	虎跃涧
ao ong eng	豹纵横
e an II	鹤展翅
en ve	六神诀 兽神诀 坤月 暗空神诀 火尊诀 猿震岳
an en ve	猿震岳
ou u ve	炼铁手之炼铁手五诀
ie ou u ve	炼铁手之炼铁手五诀
u ang ei	五怒狂雷 断土狂雷 虎皇腿
an u ang ei	断土狂雷
o en ian	太火焚天 御火吞天 血火沉天 达摩神剑 达摩神剑
v o en ian	御火吞天
ei ong ian	一飞冲天 暴雷轰天 灭水空焰
ie ei ong ian	灭水空焰
u ian ang	绝木乾罡
ve u ian ang	绝木乾罡
in an ve	化金元诀 第一阳心坎穴
a in an ve	化金元诀
ang ou ao	石黑龙自创柔道
I ang ou ao	石黑龙自创柔道
II u en	追魂十五滚
en II u en	追魂十五滚
ie ie	拦腰截劫 斩钉截铁
ao ie ie	拦腰截劫
an ao ie ie	拦腰截劫
i ei ong ian	一飞冲天
in ve	冰心诀 圣心诀 圣心诀 童心诀 童心诀
eng in ve	圣心诀 圣心诀
en an vn	万仞穿云 万刃穿云
an en an vn	万仞穿云 万刃穿云
ian ang ei	帝天狂雷 帝天狂雷
i ian ang ei	帝天狂雷 帝天狂雷
o o ou	魔佛手
u en ei	魔佛輪迴
o u en ei	魔佛輪迴
en o in	佛問魔心
u en o in	佛問魔心
ve ang in	魔血狂臨
o ve ang in	魔血狂臨
in o ao	轉心魔道
an in o ao	轉心魔道
o u ong eng	魔渡眾生
ian u ao	回天無道
ei ian u ao	回天無道
o u ang II	魔佛降世
ong ong ai	魔從中來
o ong ong ai	魔從中來
ei o ou	大悲佛手
a ei o ou	大悲佛手
ian en en	乾坤身 悲天刎人
ei ian en en	悲天刎人
ei u an ian	淚佛觀天
u ang o	巨佛降魔
v u ang o	巨佛降魔
ian ie ai ou	七箭截脉手
an ing	一箭化三清 凶暴乱影 移形换影 观音乱影
a an ing	一箭化三清
ian a an ing	一箭化三清
i ong ian	冰火七重天 双箭击通天 魔光七重天
ian i ong ian	双箭击通天
an an i	三箭断璇玑
ian an an i	三箭断璇玑
o v an	四箭破巨关
ian o v an	四箭破巨关
ian ang i ai	五箭伤气海
ei ian ing	六箭碎天灵 怒碎天灵
ian ei ian ing	六箭碎天灵
ei ong i	七箭碎中极
ian ei ong i	七箭碎中极
en in ou	分金手
o o	分金夺魄 噬魂夺魄 神鹰夺魄
in o o	分金夺魄
en in o o	分金夺魄
u ei	怒毁 无坚不摧 有巢筑垒 穹苍无悔 逆天无悔
ian u ei	无坚不摧 逆天无悔
u ian u ei	无坚不摧
i ou in	釜底抽薪
u i ou in	釜底抽薪
ing ie ie	斩钉截铁
an ing ie ie	斩钉截铁
in an v	碎金断玉
ei in an v	碎金断玉
e ing ong	配合轻功
ei e ing ong	配合轻功
ei ong u	飞纵术
i i ou	混元霹雳手 裂魔霹雳手
o i i ou	裂魔霹雳手
ie i i	群邪辟易
vn ie i i	群邪辟易
ang i ai eng	荡夷歪风
o ie	天火劫 暴火劫 气破界 烈火劫 神火劫 观音火劫 轰天破邪 飞花落叶 鬼火劫
ian o ie	天火劫 轰天破邪
ong ian o ie	轰天破邪
vn ou	七路翻云手 大风云手
eng vn ou	大风云手
a eng vn ou	大风云手
eng an vn	破风断云
o eng an vn	破风断云
eng an an vn	风卷残云 风卷残云 风卷残云 风卷残云 风卷残云
o eng	崩云破风 破梦
vn o eng	崩云破风
eng vn o eng	崩云破风
v eng	排云驭风
vn v eng	排云驭风
ai vn v eng	排云驭风
vn i ei	风云际会
eng vn i ei	风云际会
ing ao ou	蛇形刁手
e ing ao ou	蛇形刁手
e an ve	毒蛇探穴 灵蛇探穴
ing e an ve	灵蛇探穴
u e u in	毒蛇吐信
a ou in	如来大手印 如来大手印
ai a ou in	如来大手印 如来大手印
ian ve ou	碎天絕手
ei ian ve ou	碎天絕手
ei i II	完美一式 霸腿七式
an ei i II	完美一式
I ou an	大慈咒圈
a I ou an	大慈咒圈
o ong eng	怜我众生
ian o ong eng	怜我众生
ong ou	百变擒龙手 铜头
in ong ou	百变擒龙手
ian in ong ou	百变擒龙手
o o ong	铁索锁龙
ie o o ong	铁索锁龙
an vn ou	七路翻云手
u an vn ou	七路翻云手
ie vn ai ing	裂云摘星
ian ve	刀渊剑岳 刀霸剑绝 寒天绝 惊天诀 拨云见月 皇极惊天诀 第二阳丹田穴 诛天诀 轩辕惊天诀
vn ian ve	拨云见月
o vn ian ve	拨云见月
ei a i ou	五雷化殛手
ie ian ei	五灭天雷 蝎鞭腿
u ie ian ei	五灭天雷
u u ang ei	五怒狂雷
e i ve	灵蛇七绝
ing e i ve	灵蛇七绝
u e an ve	毒蛇探穴
u ou ong	蛇步游踪
e u ou ong	蛇步游踪
u e u ong	毒蛇出洞
ou a u	散手八扑
an ou a u	散手八扑
ei in ei	摧心锥
o ing an	破冰钻
an i i ou	混元霹雳手
an ai ou	唐尸三百手
II an ai ou	唐尸三百手
ou ou ou	尸撕裂魂搜飕手
en ou ou ou	尸撕裂魂搜飕手
an ve ou	烈元绝手
ie an ve ou	烈元绝手
ve ou in	血手印
ei ong in	归空印
ei ian ou in	大黑天手印
ei ou	万势归幽 倒踢北斗 冥界门前恨回首 千手捎來千杯酒 即展眉头 即展眉头 恶麟回首 辟邪大悲手 追魂鬼手 醉掛北斗 醉酒倒踢北斗 阴司魅手
I ei ou	阴司魅手
in I ei ou	阴司魅手
ei ai en	双鬼拍门 铁拐李旋肘膝撞醉还真
ang ei ai en	双鬼拍门 铁拐李旋肘膝撞醉还真
vn an	两极循环 天道循环 天道循环 烟消云散 青云转
ao vn an	天道循环 天道循环 烟消云散
ian ao vn an	天道循环 天道循环 烟消云散
en ei ou	冥界门前恨回首 追魂鬼手
ei en ei ou	追魂鬼手
ing ei u	魅影鬼步 魅影鬼步
ei ing ei u	魅影鬼步 魅影鬼步
I ou	百蛛缠丝手 盘丝手
an I ou	百蛛缠丝手 盘丝手
eng in	一网成擒
ang eng in	一网成擒
i ang eng in	一网成擒
a ou	剥皮挖肉 拈衣擒拿手 鹰爪擒拿手
in a ou	拈衣擒拿手 鹰爪擒拿手
i in a ou	拈衣擒拿手
ing e ou	恶毒灵蛇手
u ing e ou	恶毒灵蛇手
an u ou	一醉能解萬古愁 千蛛万毒手
u an u ou	千蛛万毒手
u an I ou	百蛛缠丝手
ai u II	力在布施 白骨指
an ong en	血染红尘 醉看紅塵
ve an ong en	血染红尘
in en	不坏金身 修羅金身 刀枪不入龙鳞身 大祸临门 天魔金身 无常擒魂 童子金身 童子金身 达摩金身 达摩金身 阎罗阴神
o in en	修羅金身 大祸临门 天魔金身 达摩金身 达摩金身 阎罗阴神
a o in en	大祸临门 达摩金身 达摩金身
u o II	千夫所指 意无所执
ian u o II	千夫所指
an ie an ao	万劫难逃
en en II	三分神指
an en en II	三分神指
ie v	断金切玉
in ie v	断金切玉
an in ie v	断金切玉
an o i	十万火急
II an o i	十万火急
en ian a	三分天下
an en ian a	三分天下
in II	吸阴式 幻阴指 明心始 棂豫金指
v in II	棂豫金指
ing v in II	棂豫金指
ei v an	棂霏玉婵
ing ei v an	棂霏玉婵
ing u ve	蓉莛暮雪
ong ing u ve	蓉莛暮雪
ing ang ve	豫嫇望月
v ing ang ve	豫嫇望月
a ian II	后发先至 女娲炼石 雪花仙指
ve a ian II	雪花仙指
ian ian a an	天仙下凡
en II u	仙人指路 勾魂蚀骨
ian en II u	仙人指路
v an a	仙女散花
ian v an a	仙女散花
ei ian	天外飞仙 毁天 蝎尾飞鞭 追电 霹雳摧天
ai ei ian	天外飞仙
ian ai ei ian	天外飞仙
ai en ian	六脉神剑 煮海焚天
ou ai en ian	六脉神剑
ang ian	元阳篇 双阳剑 商阳剑 大商剑 大阳剑 大阳剑 少商剑 少商剑 少阳剑 少阳剑 霞荡剑 霹雳狂电
ao ang ian	少商剑 少商剑 少阳剑 少阳剑
ang ang ian	双阳剑 商阳剑
ao ong ian	少冲剑 少冲剑
ao e ian	少泽剑 少泽剑
ang en ian	九阳神剑 九阳神剑 逆阳神鉴
ou ang en ian	九阳神剑 九阳神剑
a ang ian	大商剑 大阳剑 大阳剑 霞荡剑
a ong ian	大冲剑
a e ian	大泽剑
ing ong o II	惊虹破日
ie ian	浑天邪剑
ian ie ian	浑天邪剑
en ian ie ian	浑天邪剑
en en ian	昆仑剑 混沌剑
i ve ian	碧雪剑
ing e ian	星河剑
ian ai ian	靛海剑
ian ei an	七剑归元 万剑归元
i ian ei an	七剑归元
a o en ian	达摩神剑 达摩神剑
o an ian	达摩禅剑
a o an ian	达摩禅剑
u u ang	一菩渡江
i u u ang	一菩渡江
an ou u	罗汉叩佛
o an ou u	罗汉叩佛
ong an ao	神通弹道
en ong an ao	神通弹道
ai u	十面埋伏 无常开路 黄土埋骨
ian ai u	十面埋伏
II ian ai u	十面埋伏
o a ang	天罗杀网
ian o a ang	天罗杀网
ie ing	旱雷灭顶 灭性 罗汉卸兵 菩萨灭顶 血光灭顶 贝叶经 野狼猎鹰
ei ie ing	旱雷灭顶 贝叶经
an ei ie ing	旱雷灭顶
II en ong	一以贯之神功 上天下地至尊功 弹指神通 至尊功
an II en ong	一以贯之神功 弹指神通
an en ong	弹神通 旋神通 贯神通
II an	回头是岸 金刚一指禅
i II an	金刚一指禅
ang i II an	金刚一指禅
o ang ang	冰火螳螂 星火相撞
ing o ang ang	冰火螳螂 星火相撞
o e	天机莫测 暗黑之神魔般若 神魔合 螳臂破车 风兮破地
i o e	天机莫测 螳臂破车 风兮破地
ang i o e	螳臂破车
ang en in an	螳螂问心圈
a i ing	刁打七星
ao a i ing	刁打七星
ao in	崩步撩阴 毒蝎撩阴
u ao in	崩步撩阴
eng u ao in	崩步撩阴
ao an ou	镰刀断头
ian ao an ou	镰刀断头
e e	火螳割禾
ang e e	火螳割禾
o ang e e	火螳割禾
ing o ei II	冰火碎尸
o ie ang	血火邪罡
ve o ie ang	血火邪罡
ong ei II	火龙追日
o ong ei II	火龙追日
o ei ong	血火雷动
ve o ei ong	血火雷动
ian ian II	纯阳乾天指
ang ian ian II	纯阳乾天指
an ian II	纯阴玄天指 般若梵天指
in an ian II	纯阴玄天指
an en II	五转分尸 太玄神指
ai an en II	太玄神指
ing ian en	指定乾坤 雷霆电震
II ing ian en	指定乾坤
ian i o e	天机莫测
eng ao ang	双凤朝凰
ang eng ao ang	双凤朝凰
e ong ian an	合纵连环
ong i ian	惊虹一现
ing ong i ian	惊虹一现
ei ang i	火雷罡气
o ei ang i	火雷罡气
ei u II	碎骨指
ing an ve	飞星赶月
ei ing an ve	飞星赶月
ang ong an II	双虹贯日
ong ian ang	百孔千疮
ai ong ian ang	百孔千疮
e an ian II	般若梵天指
ou II an	回头是岸
ei ou II an	回头是岸
u eng II	毒蜂指
i u	第十八式青龙嫉主 腐肌蚀骨奇毒 锋芒毕露 雨打芭蕉凤栖梧
ang i u	锋芒毕露
eng ang i u	锋芒毕露
eng ao e	狂蜂暴蜇
ang eng ao e	狂蜂暴蜇
u an ao	蜂毒贯脑
eng u an ao	蜂毒贯脑
en ve II	牙刃血指
a en ve II	牙刃血指
ang ie ing	血光灭顶 野狼猎鹰
ve ang ie ing	血光灭顶
v an II	玉簪指
i i ian	灵犀一点
ing i i ian	灵犀一点
i i II	灵犀一指 灵犀一指
ing i i II	灵犀一指 灵犀一指
ai ian i	断脉剑气
an ai ian i	断脉剑气
i in ang II	大力金刚指
an an II	判官指 罗汉禅指
o an an II	罗汉禅指
i ang II	一阳指 无的放矢
an in II	幻阴指
eng ao	冥生道 冥生道 回生道 回生道 大漠风暴 白骨阴风爪 阴风爪
in eng ao	白骨阴风爪 阴风爪
a ai en	阴差拍门
in a ai en	阴差拍门
o o an	王婆拨扇
ang o o an	王婆拨扇
ao en	厉鬼招魂 无常招魂
ang ao en	无常招魂
u ang ao en	无常招魂
a o ing	夜叉索命
ie a o ing	夜叉索命
ei ei II	百鬼碎尸
ai ei ei II	百鬼碎尸
i ao	十方奇招 无极爪 礼道 菩提道 钢羽煞气爪 铁拐李葫芦系腰间离拐即倒 阿鼻道 阿鼻道 阿鼻道 骄阳熠耀
u i ao	无极爪 菩提道
en u ing	乾坤无定 乾坤无量/乾坤无定
ian en u ing	乾坤无定 乾坤无量/乾坤无定
a ang o	阴差阳错 阴差阳错
in a ang o	阴差阳错 阴差阳错
II i ai eng	十级台风
ao ei ong ian	暴雷轰天
ei ing ian en	雷霆电震
ei ang eng	怒毁长城
u ei ang eng	怒毁长城
o ong ang	气夺穹苍 锁龙网
i o ong ang	气夺穹苍
ing ang ao	夺命狼爪 恶鹰藏爪
o ing ang ao	夺命狼爪
ang u u	孤狼扑兔 慈航普渡
u ang u u	孤狼扑兔
ie ang ie ing	野狼猎鹰
ao u	焦土 饿狼剿虎
ang ao u	饿狼剿虎
e ang ao u	饿狼剿虎
ang u II	九狼逐日 疯狼屠狮
eng ang u II	疯狼屠狮
ian ei ao	赤炼鬼爪
II ian ei ao	赤炼鬼爪
ou en	妖锁囚神 愁困 猛鬼叩门
ei ou en	猛鬼叩门
eng ei ou en	猛鬼叩门
ou ai	饿鬼投胎
ei ou ai	饿鬼投胎
e ei ou ai	饿鬼投胎
ei an en	冤鬼缠身 千雷万震
an ei an en	冤鬼缠身
e ei ing II	恶鬼凌迟
ei o ao an	鬼火燎原
a a ao	阎罗八杀爪
o a a ao	阎罗八杀爪
ao en a	招魂杀
ve ai a	绝代杀
II a	以身试法 分尸杀
en II a	以身试法 分尸杀
ei en a	追魂杀
e a	动地杀 醉踏風火鬼神避之哪吒
ong e a	动地杀
o a	天罗撒 阎罗杀 骷髅魔甲 骷髅魔甲
ian o a	天罗撒 阎罗杀
ing in ao	刻骨铭心爪
u ing in ao	刻骨铭心爪
u o ao	刻骨破脑
e u o ao	刻骨破脑
ao o ou	破脑锁喉
o ao o ou	破脑锁喉
u o an	借醉三分战意狂之伏虎罗汉 刻骨破腕
e u o an	刻骨破腕
u e i	刻骨折膝
e u e i	刻骨折膝
e u ing in	刻骨铭心
u en ian	刻骨分肩
e u en ian	刻骨分肩
i o	刻骨离裸 异火 雷霆霹雳破
u i o	刻骨离裸
e u i o	刻骨离裸
ong u a	无影无踪步法
u ong u a	无影无踪步法
ian i II	紫焰七势
I ian i II	紫焰七势
en ing an	神鹰版
e II in	恶狮擒
e ang II	饿狼噬
e u	灵蛇吐 般若伏 魔光惊蛰伏
ing e u	灵蛇吐 魔光惊蛰伏
ve an a	蚀月三杀
II ve an a	蚀月三杀
ai u ao	九死白骨爪 九死白骨爪 九阴白骨爪 四绝白骨爪 百毒爪
ve ai u ao	四绝白骨爪
II o ian	抽尸剥茧
ou II o ian	抽尸剥茧
ou II ao	破头蚀脑
o ou II ao	破头蚀脑
II u u an	尸骨如山
in ao a	神鹰八段锦爪法
an in ao a	神鹰八段锦爪法
ing o o	神鹰夺魄
en ing o o	神鹰夺魄
ing ong ian	雄鹰冲天
ong ing ong ian	雄鹰冲天
ao a in	鹰爪挖心 鹰爪挖心
ing ao a in	鹰爪挖心 鹰爪挖心
in ei ao	玄阴鬼爪
an in ei ao	玄阴鬼爪
ie a an ao	夜叉探爪
ei ao en	厉鬼招魂
i ei ao en	厉鬼招魂
ou ei en	鬼手追魂
ei ou ei en	鬼手追魂
o ang a	大漠魔狼杀
o o ang a	大漠魔狼杀
I i	云烟四起 大日紫气 狼烟四起 紫气
eng a	一倍涡轮增压 三倍涡轮增压 两倍涡轮增压 四倍涡轮增压 斩铁暴风杀 暴风沙 玄风沙 神风沙
an eng a	玄风沙
ao eng a	斩铁暴风杀 暴风沙
in i	金气 金级 金级
en eng a	一倍涡轮增压 三倍涡轮增压 两倍涡轮增压 四倍涡轮增压 神风沙
en ing ou o	神鹰九夺
ang an i	鹰扬万里
ing ang an i	鹰扬万里
ing o u	争睛夺目
eng ing o u	争睛夺目
ing eng ou	晶灵圣手 锁颈封喉
o ing eng ou	锁颈封喉
ai e ou	离踝折肘
i ai e ou	离踝折肘
in o u	分筋错骨
en in o u	分筋错骨
ie ei	天蝎腿 撕心裂肺 正邪会 穿心铁锤
in ie ei	撕心裂肺 穿心铁锤
I in ie ei	撕心裂肺
i an ou	铁翼斩首
ie i an ou	铁翼斩首
vn ao	大鹏展翼霸云霄
a vn ao	大鹏展翼霸云霄
i a vn ao	大鹏展翼霸云霄
ve en an	翻天覆地绝人寰
i ve en an	翻天覆地绝人寰
ing ing ong	无影鹰踪 无影鹰踪
u ing ing ong	无影鹰踪 无影鹰踪
II an II	鹰变十三式
ian II an II	鹰变十三式
in ie an	挖心裂胆
a in ie an	挖心裂胆
an u ie	无远弗届
u an u ie	无远弗届
II ian e	风驰电掣
eng II ian e	风驰电掣
ong ing u u	雄鹰扑兔
ou eng ei	血肉横飞
ve ou eng ei	血肉横飞
ing ian i i	晴天霹雳
i ong ao	死气冲霄 雪泥鸿爪
ve i ong ao	雪泥鸿爪
i ie ian i	一泻千里
eng o ing	捕风捉影 捕风捉影 捕风捉影
u eng o ing	捕风捉影 捕风捉影 捕风捉影
u eng u	啄目争珠
o u eng u	啄目争珠
ai i ao ve	海底捞月
ang o II	天王破日 鹰王破日 鹰王破日
ing ang o II	鹰王破日 鹰王破日
II a ao	归魂十八爪
en II a ao	归魂十八爪
u ei i	第二式玄武悲泣
an u ei i	第二式玄武悲泣
u ao ian	白虎啸天
ai u ao ian	白虎啸天
u ve en ei	朱雀恨水
ong i u	第十八式青龙嫉主
ing ong i u	第十八式青龙嫉主
in a	不死印法 两极心法 碎骨擒拿 配合心法
u in a	碎骨擒拿
ei u in a	碎骨擒拿
eng o ang	兴风作浪
ing eng o ang	兴风作浪
u ei ian ing	怒碎天灵
u an in	碎骨穿心
ei u an in	碎骨穿心
u ei in	万毒归心 碎骨摧心
ei u ei in	碎骨摧心
ou o ao	修罗道 裂头破脑
ie ou o ao	裂头破脑
ing ao ong	大力鹰爪功
i ing ao ong	大力鹰爪功
i ing ang	万里鹰扬
an i ing ang	万里鹰扬
ing in ang	双鹰擒蟒
ang ing in ang	双鹰擒蟒
ing ian i	麻鹰敛翼
a ing ian i	麻鹰敛翼
ing ve	惊灵绝 流星诀 流星诀 第三阳足阳明胃经穴 第五阳手太阳小肠经穴 第六阳手少阳三焦经穴 第四阳足太阳膀胱经穴 雄鹰跃
ong ing ve	雄鹰跃
ing u	借花敬佛 双鹰扑
ang ing u	双鹰扑
ing ang ou	鹰抢球
e ing ang ao	恶鹰藏爪
ie ing ei	万劫鹰喙 断魂蝎钉腿 旷野惊雷
an ie ing ei	万劫鹰喙
ei ei en	蝎尾追魂 鹰喙追魂
ing ei ei en	鹰喙追魂
an ing o II	残鹰落日
ing an ong	飞鹰盘空
ei ing an ong	飞鹰盘空
ing an ao	鹰旋刀
o i ai	麻鹰捉鸡仔
ing o i ai	麻鹰捉鸡仔
ei o u	鹰喙夺珠
ing ei o u	鹰喙夺珠
ing an u	群鹰乱扑
vn ing an u	群鹰乱扑
ao in a ou	鹰爪擒拿手
ao eng ou	鹰爪封喉
ing ao eng ou	鹰爪封喉
ing ao an in	鹰爪穿心
a u ao ong	铁沙虎爪功
u o ve	神州伏魔诀 般若伏魔诀 飞虎破嶽
ei u o ve	飞虎破嶽
ou ing II	虎口凌迟
u ou ing II	虎口凌迟
an II ao	九阴寒尸爪 断肢道 断肢道
in an II ao	九阴寒尸爪
an ang in	反荡劲
ie in	撕裂劲 罗汉卸劲
I ie in	撕裂劲
ao o in	爆破劲
o i in	挪移劲
I ai u ao	九死白骨爪 九死白骨爪
II en ei	五世轮回 再世轮回
ai II en ei	再世轮回
I i ong ao	死气冲霄
II an ou	断肢斩首
an II an ou	断肢斩首
ian ang ao	天上道 天香爪
en v	圣火焚躯 炮烙焚躯 色授魂与 身无寸缕
ou en v	色授魂与
e ou en v	色授魂与
ao v en	香销玉损
ang ao v en	香销玉损
ou en II u	勾魂蚀骨
ei ian I	百媚千姿
ai ei ian I	百媚千姿
ing ao	叱咤风云霸凌霄 天鹰爪 灵霄 血雨晶刀 风中劲草
ian ing ao	天鹰爪
ing ing ang	千鹰并翔
ian ing ing ang	千鹰并翔
ing ve II	天鹰攫日
ian ing ve II	天鹰攫日
ian ei ve	翻天碎月
an ian ei ve	翻天碎月
ing an ou	千鹰万寿
ian ing an ou	千鹰万寿
en ing o II	神鹰破日
an i ong	三一元气功 鹰旋万里空
an an i ong	鹰旋万里空
u in eng ao	白骨阴风爪
en o o	噬魂夺魄
II en o o	噬魂夺魄
＆ u ao	兽穴法＆虎爪
a ＆ u ao	兽穴法＆虎爪
ing ang ang	鬼影幢幢
ei ing ang ang	鬼影幢幢
ve ie ao	血劫爪
ie an an	千劫万难
ian ie an an	千劫万难
ve ing II	邪血凌迟
ie ve ing II	邪血凌迟
ing ei ao	幽冥鬼爪
ou ing ei ao	幽冥鬼爪
u o ou	白骨锁喉
ai u o ou	白骨锁喉
e ong	枯骨乐踊 电殛恶龙 逍遥极乐功 龙象般若功
u e ong	枯骨乐踊
u u e ong	枯骨乐踊
ao en II	冥爪分尸
ing ao en II	冥爪分尸
II o	元始搏 天惊石破 幽冥噬魄
ing II o	天惊石破 幽冥噬魄
ou ing II o	幽冥噬魄
ing en a	鬼影身法
ei ing en a	鬼影身法
ao v	暴雨 腥风暴雨 阴雷暴狱
eng ao v	腥风暴雨
ing eng ao v	腥风暴雨
ao in ong	五爪金龙 毒爪擒龙
u ao in ong	五爪金龙 毒爪擒龙
u i u	腐肌蚀骨奇毒
II u i u	腐肌蚀骨奇毒
a i ao	钢羽煞气爪 阿鼻道 阿鼻道 阿鼻道
v a i ao	钢羽煞气爪
ou en II	啄肉分尸
o ou en II	啄肉分尸
ei ing u u	飞鹰扑兔
ing en II	大鹰振翅 鲸吞势
a ing en II	大鹰振翅
ei ian ie	万雷灰飞烟灭 灰飞烟灭 灰飞烟灭
ei ei ian ie	万雷灰飞烟灭 灰飞烟灭 灰飞烟灭
ie ong ao ou	铁龙爪手
ian ong u ai	千龙出海
in ai u ao	九阴白骨爪
ve ao	修罗絕道 化血爪 血雪爪 雪雹 雷电门三大绝招
ve ve ao	血雪爪
a ve ao	化血爪 雷电门三大绝招
en ei ao	勾魂鬼爪
ou en ei ao	勾魂鬼爪
ou ang eng	无有相生 血肉长城 血肉长城 醉守蒼生
ve ou ang eng	血肉长城 血肉长城
o ei ao	夺魄鬼爪
o o ei ao	夺魄鬼爪
ei vn ei	追云腿
ong ei i	云踪霏迷
vn ong ei i	云踪霏迷
vn ian eng ong	云现风涌
ian I i	云烟四起 狼烟四起
vn ian I i	云烟四起
ian an ei	天残腿 天残腿 恶电三摧
ao eng en	天残小风轮
an ao eng en	天残小风轮
ei ai	横祸飞来
o ei ai	横祸飞来
eng o ei ai	横祸飞来
a eng en	天残大风轮
an a eng en	天残大风轮
ian an ei en	天残飞轮
e II	动地式 天残射日 神光射日 穿云射日 穿云射日
an e II	天残射日
ian an e II	天残射日
ie ei ing	天残蝎尾钉
an ie ei ing	天残蝎尾钉
an o in	天残破金
ian an o in	天残破金
an o u	天残破木
ian an o u	天残破木
ian an o II	天残破石
eng en ei	风神腿
ong ing ao	风中劲草
eng ong ing ao	风中劲草
v ang eng	暴雨狂风
ao v ang eng	暴雨狂风
eng ing	三步风行 千里横行 雷厉风行
i eng ing	千里横行 雷厉风行
ei i eng ing	雷厉风行
an ou an	风卷楼残
eng an ou an	风卷楼残
eng u ao	神风怒嚎
en eng u ao	神风怒嚎
i en ei	拜揖门楣 霹雳神腿
i i en ei	霹雳神腿
ei eng II	追风式
ong e II	动地式
ing ian II	惊天式
ian en ei	雷电分飞 雷电神腿 雷电神腿
ei ian en ei	雷电分飞 雷电神腿 雷电神腿
ian ang u ian	电光初现 电光初现 电光初现
en ei a ang	春雷乍響
e ing ian u	蛇形电步 蛇形电步
o vn ei	捷若迅雷
ie o vn ei	捷若迅雷
ang an ou	电光斩首 电光斩首
ian ang an ou	电光斩首 电光斩首
an er	如雷贯耳 如雷贯耳
ei an er	如雷贯耳 如雷贯耳
u ei an er	如雷贯耳 如雷贯耳
ang en ei	电光分飞 裂地蟒神腿
ian ang en ei	电光分飞
ong ou ian	雷动九天 雷动九天 雷动九天 雷动九天
ei ong ou ian	雷动九天 雷动九天 雷动九天 雷动九天
ang u ong an	电光毒龙钻 电光毒龙钻 电光毒龙钻
ing an vn	雷霆万钧 雷霆万钧
ei ing an vn	雷霆万钧 雷霆万钧
ou II	梵天救世 雷电神腿首六式
ou ou II	雷电神腿首六式
ei ou ou II	雷电神腿首六式
ei ian eng ong	雷电横空 雷电横空
ang o ing	电光破岭 金杨破岭
ian ang o ing	电光破岭
a ei	修罗怒杀腿 穿金破石象牙锥 逆天霸腿 降龙十八腿 降龙十八腿 降龙十八腿 雷麟霸腿
in a ei	雷麟霸腿
ei in a ei	雷麟霸腿
in ei ou	恶麟回首
e in ei ou	恶麟回首
a ian an	麟霸千山
in a ian an	麟霸千山
in o ing	潜麟过岭
ian in o ing	潜麟过岭
eng v	暴蹄崩狱
i eng v	暴蹄崩狱
ao i eng v	暴蹄崩狱
ian an ian ei	箭拳箭腿
ou a ian II	后发先至
a II en	先发制人
ian a II en	先发制人
an an i i	三元及第
u i ang II	无的放矢
ai u an ang	百步穿扬
vn e II	穿云射日 穿云射日
an vn e II	穿云射日 穿云射日
a ai ong	百发百中
ai a ai ong	百发百中
ei u ong an	箭腿毒龙钻
an ong ao	梅花三弄脚
a an ong ao	梅花三弄脚
v e	寒山绿萼
an v e	寒山绿萼
an an v e	寒山绿萼
an v ing	姗姗绿影
an an v ing	姗姗绿影
ie o ei	三叠落梅
an ie o ei	三叠落梅
ie an ei	乾坤裂山腿
en ie an ei	乾坤裂山腿
ao an ian en	倒转乾坤
ei u ve	怒碎五岳
u ei u ve	怒碎五岳
en ou ou	裂分九州 雷动山河震九州
ie en ou ou	裂分九州
e ang en ei	裂地蟒神腿
er II	择肥而噬
ei er II	择肥而噬
e ei er II	择肥而噬
ang ou u in	昂首吐信
ang eng ong	毒蟒横空
u ang eng ong	毒蟒横空
ing ang u	蛇行蟒伏
e ing ang u	蛇行蟒伏
ve u	獠牙绝毒
a ve u	獠牙绝毒
ao a ve u	獠牙绝毒
ing e ai ei	灵蛇摆尾
ang an an	巨蟒盘缠
v ang an an	巨蟒盘缠
an u ei in	万毒归心
ian a ei	逆天霸腿
i ian a ei	逆天霸腿
vn u ai	颠云覆海
ian vn u ai	颠云覆海
i ei ou	倒踢北斗 醉酒倒踢北斗
ao i ei ou	倒踢北斗 醉酒倒踢北斗
ei ian ong	霸碎天宫
a ei ian ong	霸碎天宫
i ian u ei	逆天无悔
II a ei	降龙十八腿 降龙十八腿 降龙十八腿
ong II a ei	降龙十八腿 降龙十八腿 降龙十八腿
ang ong ian ei	双龙剪水 双龙剪水
ong en ei	降龙神腿
ang ong en ei	降龙神腿
a ong ou ao	杀龙求道
II an ei	追命十三腿 阴世幻腿
ing II an ei	追命十三腿
e ei a	般若腿法
o e ei a	般若腿法
ian an ian	一念三千 无间串莲
i ian an ian	一念三千
ing eng	佛性明灯 穹苍腥风
ing ing eng	佛性明灯
o ing ing eng	佛性明灯
ian an ong	一念圆融 天蚕功
i ian an ong	一念圆融
I ai ei	蝎子摆尾 蝎子摆尾
ie I ai ei	蝎子摆尾 蝎子摆尾
ie e ian	毒蝎车鞭
u ie e ian	毒蝎车鞭
ei ei ian	蝎尾飞鞭
ie ei ei ian	蝎尾飞鞭
ie ang ou	巨蝎昂首
v ie ang ou	巨蝎昂首
ie ing ong	双蝎行空
ang ie ing ong	双蝎行空
ing ao a	无影脚法
u ing ao a	无影脚法
a i ian	昙花一现
an a i ian	昙花一现
ing u ing	如影附形
u ing u ing	如影附形
ang e II	神光射日
en ang e II	神光射日
ang ei a	霸王腿法
a ang ei a	霸王腿法
ao ang ong	日曜长空 直捣黄龙
II ao ang ong	日曜长空 直捣黄龙
ian vn	吕洞宾醉酒提壶力千钧 横扫千军 蝎尾扫千军 飞渡烟云
ao ian vn	横扫千军 蝎尾扫千军
eng ao ian vn	横扫千军
vn ou e	将军抽车
ang vn ou e	将军抽车
ang o ai	飞将夺帅
ei ang o ai	飞将夺帅
ei an e	怒碎山河
u ei an e	怒碎山河
u ei ao	虎尾脚 虎尾脚
u ian i	焦土千里 虎千击
u ian in	虎千斤
an eng an	轰雷旋风转
ei an eng an	轰雷旋风转
i i o	雷霆霹雳破
ing i i o	雷霆霹雳破
ong ei a	芙蓉腿法
u ong ei a	芙蓉腿法
ei ing ang	蓉桂兢芳 雷霆象
ong ei ing ang	蓉桂兢芳
an an u	苣兰芟锄
v an an u	苣兰芟锄
ou ai II	银柳摆枝
in ou ai II	银柳摆枝
o v	刀山火狱 怡红浊玉 惊雷魔雨 离魂魔狱 金阳破狱
ong o v	怡红浊玉
i ong o v	怡红浊玉
a an ong	梅花三弄
ei a an ong	梅花三弄
a I in	繁花似锦
an a I in	繁花似锦
a ei i II	霸腿七式
eng an u u	一将功成万骨枯
en o ing	平步登天任我行 饮恨魔经
ian en o ing	平步登天任我行
a ing ao	叱咤风云霸凌霄
vn a ing ao	叱咤风云霸凌霄
an u i	攻无不克战无敌 盘古击 蓝菩提
e an u i	攻无不克战无敌
a ing ian a	千军万马惊天下
e en ou ou	雷动山河震九州
i ai II	石破天惊气盖世
ing i ai II	石破天惊气盖世
en eng ong	神风动
v ang u	风雨江湖
eng v ang u	风雨江湖
ong eng vn	动风云
I II	天魔四蚀 杀神四式 闪电四式 飞云四式
vn I II	飞云四式
ei vn I II	飞云四式
ai ian II	云开见日
vn ai ian II	云开见日
ian vn ian	过眼云烟
o ian vn ian	过眼云烟
a en ei	天马神腿
ian a en ei	天马神腿
a ing ong	天马行空
ian a ing ong	天马行空
v o i	白驹过隙
ai v o i	白驹过隙
ei a ang i	飞马张翼
an a en eng	万马奔腾 万马奔腾
ie a ei a	铁家腿法
ang ao ian	恶浪滔天 朝阳耀天 洪荒浩焰 饿狼哮天 饿狼啸天
e ang ao ian	恶浪滔天 饿狼哮天 饿狼啸天
en u	山神震怒 雷神震怒
en en u	山神震怒 雷神震怒
an en en u	山神震怒
ei a ian i	飞马献蹄
ing an II	流星赶日
ou ing an II	流星赶日
ing an ing	移形换影
i ing an ing	移形换影
en i i	鬼神辟易
ei en i i	鬼神辟易
II u ve ei	阳世五绝腿
in II an ei	阴世幻腿
in ang ei	大力金刚腿 密宗金刚腿 少林金刚腿
i in ang ei	大力金刚腿
I ei	少年不識酒滋味 毒蝎刺腿
ie I ei	毒蝎刺腿
u ie I ei	毒蝎刺腿
e ian ao	百蜇千螯
ai e ian ao	百蜇千螯
ie ei ei en	蝎尾追魂
ie ei ei	蝎尾腿
ing eng ai ou	迎风摆柳
ie ao in	毒蝎撩阴
u ie ao in	毒蝎撩阴
ie an in	截拳劲 毒蝎穿心
u ie an in	毒蝎穿心
ei ao ian vn	蝎尾扫千军
ian ie ei	天蝎腿
ie eng ou	毒蝎封喉
u ie eng ou	毒蝎封喉
ie ei ing en	蝎尾钉魂
in in ang ei	少林金刚腿
ang en ao	金刚伸腰
in ang en ao	金刚伸腰
ei II ao	碎石脚
ie ou ao	裂头脚
en ie ing ei	断魂蝎钉腿
ai an ao	跆拳道
I u	冰寒刺骨 冰寒刺骨 飞云四步
vn I u	飞云四步
ei vn I u	飞云四步
u eng ian	一步登天
i u eng ian	一步登天
u eng ong	二步横空
er u eng ong	二步横空
u eng ing	三步风行
an u eng ing	三步风行
u en ou	四步神游
I u en ou	四步神游
ing u ong	无影无踪
u ing u ong	无影无踪
ing ei ing	如影随形 无定飞星
u ing ei ing	如影随形 无定飞星
ing ou vn	形影流云
ing ing ou vn	形影流云
ing ou ong	鱼影游踪
v ing ou ong	鱼影游踪
ou en a	玄宇宙身法
v ou en a	玄宇宙身法
en ang an	身光闪
ao u u	鸟渡术
o ei u	凌波微步
ing o ei u	凌波微步
ei o i	水挪移
en u ve	盘古真武诀
u en u ve	盘古真武诀
II in ong	末日隐空
o II in ong	末日隐空
i an a	两极玄甲
ang i an a	两极玄甲
ao an ing	凶暴乱影
ong ao an ing	凶暴乱影
e ve	天灭地绝 斜侧削 斧啸河岳 破地诀 长恨歌诀
ao e ve	斧啸河岳
u ao e ve	斧啸河岳
ing ong i	雷霆轰击
ei ing ong i	雷霆轰击
en en ei	离恨分飞
i en en ei	离恨分飞
ian eng en	一念成仁
i ian eng en	一念成仁
I ve i	唐门四绝器
en I ve i	唐门四绝器
ou ong ong	杀手空空
a ou ong ong	杀手空空
a ing u	借花敬佛
ie a ing u	借花敬佛
ing an i	土星战气 无形暗器 木星战气 水星战气 火星战气 金星战气
u ing an i	土星战气 无形暗器 木星战气
an u ian II	暗无天日
u o i	万物如我意
u u o i	万物如我意
i ong an e	一器动山河
i u i	杀器护体
a i u i	杀器护体
ang u ai	金刚不坏
in ang u ai	金刚不坏
ao an e	剑啸山河 电爪战车
ian ao an e	剑啸山河 电爪战车
in ie e	水银泻地
ei in ie e	水银泻地
ian i e	倒天逆地
ao ian i e	倒天逆地
ang ing ong	逆浪行凶
i ang ing ong	逆浪行凶
u ian vn	飞渡烟云
ei u ian vn	飞渡烟云
ian ei ing	驭电追星
v ian ei ing	驭电追星
ei v ong	割碎虚空 拳碎虚空
e ei v ong	割碎虚空
ian i ong	剑洗千里空 电剑殛空 闪电奇功
i ian i ong	剑洗千里空
u e	天罡气诀之五行互克 寒暑着 杀无赦 泥船渡河
a u e	杀无赦
an o	无间旋涡 紫旋破 罗汉破
ian an o	无间旋涡
u ian an o	无间旋涡
ou ou ao	九幽爪
ie i ei	灭寂腿
ve en	阿鼻冥岳身
ing ve en	阿鼻冥岳身
i ing ve en	阿鼻冥岳身
ou u o ve	神州伏魔诀
ao ai ang	惊涛骇浪
ing ao ai ang	惊涛骇浪
an ei v ong	拳碎虚空
ing ou ing	飞影流星
ei ing ou ing	飞影流星
ian a ang	飞莲踏浪
ei ian a ang	飞莲踏浪
eng an u	火凤乱舞 狂风乱舞
ang eng an u	狂风乱舞
e u o ve	般若伏魔诀
ing in II	明心始
ing ie	中阶境界 初阶境界 无尚天境界 玄冰结 见性解 高阶境界
ian ing ie	无尚天境界 见性解
II a i	释法义
o an o	罗汉破
ou ie ai	六业衰
o e u	般若伏
u ian ao	无间道 无间道
en ian ao	人间道
e ei ao	饿鬼道
v ao	地狱道
i v ao	地狱道
in en o ing	饮恨魔经
ing ing eng ou	晶灵圣手
ve ong	一刀绝空 驭虚攫空
v ve ong	驭虚攫空
v v ve ong	驭虚攫空
an ao ong	明暗交融
ing an ao ong	明暗交融
u ei ong	风舞雷动
eng u ei ong	风舞雷动
u ong ang II	无弓放矢
an ian ve	刀渊剑岳 寒天绝 第二阳丹田穴
I ve	四绝 快慢九字诀 神鸟四绝 苍狼四绝
ang I ve	苍狼四绝
ang ang I ve	苍狼四绝
a a an	风沙霸拳
eng a a an	风沙霸拳
ang a ing	狼王压顶
ang ang a ing	狼王压顶
o ian ao	朔漠天刀 真魔天道
o o ian ao	朔漠天刀
o ve ao	修罗絕道
ou o ve ao	修罗絕道
ian ie en ei	青焰裂神腿
ou II en	惡兽噬神
e ou II en	惡兽噬神
u en ie u	屠神灭佛
ei ei an	修罗黑雷拳
o ei ei an	修罗黑雷拳
v ei an	地关碧绿内丹 暴雨雷拳
ao v ei an	暴雨雷拳
ou o in en	修羅金身
I ang u i	紫阳无极
o en	怒碎風火輪 无极修罗震 魔刃
ou o en	无极修罗震
i ou o en	无极修罗震
ie ve an	修罗灭绝拳
o ie ve an	修罗灭绝拳
ang ie en ei	紫阳裂神腿
en an i	灭神三极
ie en an i	灭神三极
ie an ian	破邪三限
o ie an ian	破邪三限
o an ve	达摩三绝
a o an ve	达摩三绝
o en ei	万劫不复堕轮回 达摩神腿
a o en ei	达摩神腿
ian an an ve	天残三绝
ing ian ve	惊天诀 皇极惊天诀 轩辕惊天诀
i ing ian ve	皇极惊天诀
eng ve	乘风诀 焚城诀 轮回转生诀 长生诀 长生诀 雪龙崩月 雪龙崩月
en eng ve	焚城诀
ie ang ve	灭阳诀
an ai ve	翻海诀
o e ve	破地诀
ei e ian	惊雷恶电
ing ei e ian	惊雷恶电
e ian an ei	恶电三摧
ei an ong	三火归元功 惊雷三轰
ing ei an ong	惊雷三轰
ei ian i i	雷电霹雳
ai en ong	逍遥派神功
ao ai en ong	逍遥派神功
ang en ong	九阳神功 九阳神功 无相神功 烈阳神功 烈阳神功 狮王神功 轩辕三罡神功 霸王神功
u ang en ong	无相神功
i e ong	电殛恶龙 逍遥极乐功
ao i e ong	逍遥极乐功
ang u in	采阳补阴
ai ang u in	采阳补阴
an in ou	逍遥三阴手
ao an in ou	逍遥三阴手
ang ai an	阎王开山
ian ang ai an	阎王开山
u ang ao	五路阳爪 无常爪
ang in en	无常擒魂
u ang in en	无常擒魂
ang ai u	无常开路
u ang ai u	无常开路
ang a in	无常挖心
u ang a in	无常挖心
ang u ang	阴阳无常
in ang u ang	阴阳无常
an in ang	一指判阴阳 二转阴阳 阎罗殿里判阴阳
II an in ang	一指判阴阳
ou ang u ve	九阳五绝
a o i	阴阳大挪移
ang a o i	阴阳大挪移
ie ang ao	烈阳刀
en i ve	乾坤七绝
ian en i ve	乾坤七绝
ian o ao an	天火燎原
ing i ong	九幽逆经奇功 天惊地动
ian ing i ong	天惊地动
eng i o e	风兮破地
i ao ian	水兮滔天
ei i ao ian	水兮滔天
en ie	人灭 发电伤人阶 同乎混涅 横纹切 火兮焚野 血魅邪魂劫
i en ie	火兮焚野
o i en ie	火兮焚野
ei en ing	山兮鬼神惊
i ei en ing	山兮鬼神惊
ve eng an	北岳恒山 南岳衡山
an ve eng an	南岳衡山
ve ong an	中岳嵩山
ong ve ong an	中岳嵩山
ve a an	西岳华山
i ve a an	西岳华山
ei ve eng an	北岳恒山
ve i ong	五岳齐轰
u ve i ong	五岳齐轰
ian i ei	雷兮天地碎
i ian i ei	雷兮天地碎
ei i ong	万雷齐轰
an ei i ong	万雷齐轰
ang an II	浪卷势 阴阳三式
in ang an II	阴阳三式
in ang u ao	阴阳毒爪
eng u ang	阴风毒掌
in eng u ang	阴风毒掌
ie ang u an	烈阳毒拳
ian ang ie e	电网泻地
i ian en	以气炼神 如意电震 无殛电轮 霹雳电震
i i ian en	以气炼神 霹雳电震
u i ian en	如意电震 无殛电轮
an a ve ao	雷电门三大绝招
ian ang in ong	电网擒龙
i ian en ian	地电震天
ian i e ong	电殛恶龙
in ang ong	大力金刚功
i in ang ong	大力金刚功
u u ou	诛魅普渡咒
ei u u ou	诛魅普渡咒
a ei ou	辟邪大悲手 醉掛北斗
ie a ei ou	辟邪大悲手
ao in ang in	伏妖金刚印
o ian u ang	降魔千佛掌
II a ing	阎王十杀令
ang II a ing	阎王十杀令
i a ou	剥皮挖肉
ao i a ou	剥皮挖肉
an ao an	十万刀山
II an ao an	十万刀山
ian o ai	无边火海
u ian o ai	无边火海
eng I	饿鬼争饲
ei eng I	饿鬼争饲
e ei eng I	饿鬼争饲
II ei u	炼石碎骨
ian II ei u	炼石碎骨
ing ing ei	洹灵凝髓
an ing ing ei	洹灵凝髓
ou a ao	虎头铡刀
u ou a ao	虎头铡刀
II an en	分尸散魂
en II an en	分尸散魂
o en v	圣火焚躯 炮烙焚躯
ao o en v	炮烙焚躯
II an ong	义和大日玄功 十三龙
II an ang	十三象
ei ong ao ou	撕心裂肺龙爪手
vn ang a an	横扫千军象拔拳
ang u o	力贯万斤象步堕 金刚伏魔
in ang u o	力贯万斤象步堕 金刚伏魔
ong ei ei	刁钻诡奇龙尾腿
i ong ei ei	刁钻诡奇龙尾腿
ang a ei	穿金破石象牙锥
II ang a ei	穿金破石象牙锥
ong in en	刀枪不入龙鳞身
u ong in en	刀枪不入龙鳞身
o o e	暗黑之神魔般若
en o o e	暗黑之神魔般若
ian ang o II	天王破日
er ing	逆天而行
ian er ing	逆天而行
i ian er ing	逆天而行
a ian ou	花间游
ou eng	采菊南篱愁秋风
ou ou eng	采菊南篱愁秋风
i ou ou eng	采菊南篱愁秋风
i ang ei	蝶舞翩翩戏香蕊
ian i ang ei	蝶舞翩翩戏香蕊
ang i ang	狂蜂纷飞酿蜜忙
ei ang i ang	狂蜂纷飞酿蜜忙
eng i u	雨打芭蕉凤栖梧
ao eng i u	雨打芭蕉凤栖梧
eng u a	化作春泥更护花
i eng u a	化作春泥更护花
ei a ian	醉八仙 醉八仙 醉八仙
i ian vn	吕洞宾醉酒提壶力千钧
u i ian vn	吕洞宾醉酒提壶力千钧
o in ing	汉钟醉步抱坛窝心顶
an o in ing	汉钟醉步抱坛窝心顶
ou o ou ou	曹国舅仙人敬酒锁喉扣
ei i ian an	张果老醉酒抛杯踢连环
an ao o	蓝采和单提敬酒拦腰破
ou an ao o	蓝采和单提敬酒拦腰破
ei ei ao	韩湘子擒碗击胸醉吹箫
ong ei ei ao	韩湘子擒碗击胸醉吹箫
ei ang u	何仙姑弹腰献酒醉荡步
ou ei ang u	何仙姑弹腰献酒醉荡步
ve ang ou	吕洞宾斜插宝剑醉跌岳阳楼
ie ve ang ou	吕洞宾斜插宝剑醉跌岳阳楼
ai ao ao ang	张果老倒骑毛驴摔在高桥上
ai i ao	铁拐李葫芦系腰间离拐即倒
i ai i ao	铁拐李葫芦系腰间离拐即倒
ian ao ian	曹国舅云阳见板左右颠倒颠 浑天宝鉴
ou ian ao ian	曹国舅云阳见板左右颠倒颠
o ou ao an	何仙姑乱睡象牙床左右搅反
o ou an	汉钟离手使阴阳宝扇左右扇
an o ou an	汉钟离手使阴阳宝扇左右扇
an en ian	蓝采和度沉疴就把花篮分献
a an en ian	蓝采和度沉疴就把花篮分献
an ao ian	韩湘子萧声响亮便把蟠桃献
a an ao ian	韩湘子萧声响亮便把蟠桃献
an ang ang	菩提树下啖黃汤
a an ang ang	菩提树下啖黃汤
u u o an	借醉三分战意狂之伏虎罗汉
ei a ei ou	醉掛北斗
I ai	大千世界佛自在 酒醉蕩四海
ang I ai	酒醉蕩四海
ei ang I ai	酒醉蕩四海
eng a ong ong	夢打銅鍾
vn vn	雪女霜眉眼醺醺
ian vn vn	雪女霜眉眼醺醺
ei ian vn vn	雪女霜眉眼醺醺
ao vn	後發先至力萬鈞之太上老君
ang ao vn	後發先至力萬鈞之太上老君
ai ang ao vn	後發先至力萬鈞之太上老君
ei an ong en	醉看紅塵
ou I ei	少年不識酒滋味
II ou I ei	少年不識酒滋味
II e a	醉踏風火鬼神避之哪吒
i II e a	醉踏風火鬼神避之哪吒
eng o en	怒碎風火輪
ei eng o en	怒碎風火輪
II en ou	海市蜃楼 醉眼看天庭擎槍指神州
ang II en ou	醉眼看天庭擎槍指神州
ao ong ong	醉踏風火闹龙宫
o ao ong ong	醉踏風火闹龙宫
ie an u ou	一醉能解萬古愁
ian ang i	問誰能破四面手之梵天上帝 昊天罡气
an ian ang i	問誰能破四面手之梵天上帝
ei ou ang eng	醉守蒼生
en II ang	抱酲鎮十方
eng en II ang	抱酲鎮十方
vn an ang	抱酲徜徉雲端上
ang vn an ang	抱酲徜徉雲端上
en I	呼雷引電震十方之雷震子
ei en I	呼雷引電震十方之雷震子
II ei en I	呼雷引電震十方之雷震子
ao ian ong	七十二變化無窮之醉猴鬧天宮 猴王酩酊鬧天宮
ing ao ian ong	猴王酩酊鬧天宮
ou ao ian ong	七十二變化無窮之醉猴鬧天宮
ian ei ou	千手捎來千杯酒
ai ian ei ou	千手捎來千杯酒
a II	半點空明半點柔之觀音大士 狼牙噬
in a II	半點空明半點柔之觀音大士
an in a II	半點空明半點柔之觀音大士
o u ing	九生皆醉我獨醒
ei o u ing	九生皆醉我獨醒
ai o u	五指如山乾坤定之如来佛祖 虚怀若谷
u ai o u	五指如山乾坤定之如来佛祖
ou I ve	快慢九字诀
an ou I ve	快慢九字诀
ang i an en	两极三问
en eng II	问风式
eng o an	烈风涡旋 龙腾火渊 龙腾火渊
ie eng o an	烈风涡旋
en ei II	问雷式
ian ei an en	千雷万震
i i en ong	霹雳震空
en ian II	问电式
ian an ve	紫电断岳
I ian an ve	紫电断岳
ian ian i ong	电剑殛空
ei i i	天雷霹雳 神雷一击 震雷霹雳
ian ei i i	天雷霹雳
ei u i	天雷怒劈 鬼斧劈 黑菩提
ian ei u i	天雷怒劈
ian ei ong ing	千雷轰顶 天雷轰顶
i ian ei	霹雳天雷
i i ian ei	霹雳天雷
ve ian ei	灭绝天雷
ie ve ian ei	灭绝天雷
i i an	如意七转
u i i an	如意七转
an u ang	运转无常
vn an u ang	运转无常
er an in ang	二转阴阳
an ou e	三转六合
an an ou e	三转六合
an a ang	四转八方
I an a ang	四转八方
u an en II	五转分尸
an an ei	六转幻腿
ou an an ei	六转幻腿
an en ei	七转轮回 魔光绽春雷
i an en ei	七转轮回
en ing a a	神行八法
ei ian ai	精卫填海
ing ei ian ai	精卫填海
ong v o	祝融浴火
u ong v o	祝融浴火
ong ong i an	共工移川
ao u ei	有巢筑垒
ou ao u ei	有巢筑垒
en i ie	雷震劈邪
ei en i ie	雷震劈邪
i a a	伏羲画卦 天地大法 天地大法 天魔秘大法
u i a a	伏羲画卦
v a ian II	女娲炼石
u ai ian	盘古开天
an u ai ian	盘古开天
an ei en i	完美神技
an eng vn	纷纷扰扰断风云
ao an eng vn	纷纷扰扰断风云
ie ong en	萧萧杀杀灭红尘
a ie ong en	萧萧杀杀灭红尘
ei ian en	苍苍茫茫碎乾坤
ang ei ian en	苍苍茫茫碎乾坤
ei o ao	唯我道
ang i ao	十方奇招 骄阳熠耀
II ang i ao	十方奇招
o ao ian	离火燎天
i o ao ian	离火燎天
o vn	地水破军
ei o vn	地水破军
e ei o vn	地水破军
vn eng	乾坤巽风
en vn eng	乾坤巽风
ian en vn eng	乾坤巽风
en an ve	坤仑断岳
en en an ve	坤仑断岳
en ei i i	神雷一击 震雷霹雳
e ei an	泽地归元
e e ei an	泽地归元
e an ing i	地转星移
ie e ve	天灭地绝 斜侧削
ian ie e ve	天灭地绝
ang v ie	十方俱灭
II ang v ie	十方俱灭
o en ong	圣火神功 圣火神功
eng o en ong	圣火神功 圣火神功
ie ou ang	爆裂肘撞
ao ie ou ang	爆裂肘撞
o ei i	烈火飞膝
ie o ei i	烈火飞膝
o ian ian	烽火连天
eng o ian ian	烽火连天
o ai an	烈火开山
ie o ai an	烈火开山
o ong in	烈火攻心
ie o ong in	烈火攻心
o ian an	火箭拳
o ian an vn	火箭穿云
o ao ou in	火烙手印
ao I ang	傲啸四方 火舞骄阳照四方
ang ao I ang	火舞骄阳照四方
u i ang	火舞激扬
o u i ang	火舞激扬
eng o en an	圣火神拳
eng o ao an	圣火燎原
eng o u i	圣火护体
eng o en v	圣火焚躯
o an i	無相破元气
ang o an i	無相破元气
ian o II	開天破日
ai ian o II	開天破日
II ei o	穹天赤雷破
ian II ei o	穹天赤雷破
an ian ie	七逆寒天劫
i an ian ie	七逆寒天劫
in a a	寒麟化甲
an in a a	寒麟化甲
ong ie	天人共劫 蟠龙泄 麒麟冻结
en ong ie	天人共劫
ian en ong ie	天人共劫
ian u o	逆天無我
i ian u o	逆天無我
ei ang ao	逆水狂濤
i ei ang ao	逆水狂濤
ie in ao	劫心爪
e ie	地灭 天旋地劫
an e ie	天旋地劫
ian an e ie	天旋地劫
I in a	不死印法
u I in a	不死印法
ing ai	阴风送葬索命来
o ing ai	阴风送葬索命来
ang o ing ai	阴风送葬索命来
ei an ang	生离死别催肝肠
ie ei an ang	生离死别催肝肠
ian en ei ou	冥界门前恨回首
in I	视死如归闯阴司
ang in I	视死如归闯阴司
ei ang in I	视死如归闯阴司
i an in ang	阎罗殿里判阴阳
ang ian eng	奈何桥上忘前生
ang ang ian eng	奈何桥上忘前生
u o en ei	万劫不复堕轮回
o en a	幻魔身法
an o en a	幻魔身法
I i an	不死七幻
u I i an	不死七幻
v ai II	以虚还实
i v ai II	以虚还实
ian ai an	以偏概全
i ian ai an	以偏概全
i en II a	以身试法
an i II	以卵击石 开山劈石 锋寒七式
i an i II	以卵击石
i ai ao	以逸代劳
i i ai ao	以逸代劳
ou ei u	以有为无
i ou ei u	以有为无
en u ie	以身入灭
i en u ie	以身入灭
ong i ve	神魔同体诀
o ong i ve	神魔同体诀
e v	善恶聚
an e v	善恶聚
eng ie ei	正邪会
en o e	神魔合
ian o ong	天魔功
o I II	天魔四蚀
ian o I II	天魔四蚀
o II ou	天魔蚀肉
ian o II ou	天魔蚀肉
ian o II u	天魔蚀骨
o II ing	天魔蚀经
ian o II ing	天魔蚀经
o II en	天魔蚀魂
ian o II en	天魔蚀魂
o u ve	天魔五绝
ian o u ve	天魔五绝
ian o in en	天魔金身 阎罗阴神
o i e	天魔极乐
ian o i e	天魔极乐
ian o u en	天魔怒震
o ie e	天魔裂地
ian o ie e	天魔裂地
o I ian	天魔撕天 幻魔四变
ian o I ian	天魔撕天
ian o ao	大天魔刀 天魔刀 小天魔刀
ao ian o ao	小天魔刀
a ian o ao	大天魔刀
ian o ei	天魔锥
ian o an u	天魔乱舞
ao u en a	天妖屠神法
i in II	吸阴式
ao en o	刁魂破
en ong ao	妖魂冲霄
ao en ong ao	妖魂冲霄
ian II II	吸天蚀日
i ian II II	吸天蚀日
en u eng	千魂屠城
ian en u eng	千魂屠城
o ou en	妖锁囚神
ao o ou en	妖锁囚神
ei ao ou	幻魅妖球
an ei ao ou	幻魅妖球
an ian i	妖乱天地
ao an ian i	妖乱天地
ie II	吼天灭世 妖极灭世
i ie II	妖极灭世
ao i ie II	妖极灭世
ou en ve	六神诀 兽神诀
en i an	雷神疾旋 雷神疾闪
ei en i an	雷神疾旋 雷神疾闪
en i ian	雷神疾电
ei en i ian	雷神疾电
in ang ie	金刚解
& ai ie	內解&外解
ie & ai ie	內解&外解
in ang ie i	金刚解肌
ie a	金刚解甲
ang ie a	金刚解甲
in ang ie a	金刚解甲
o an v	罗汉御
an ie in	罗汉卸劲
o an ie in	罗汉卸劲
an ie ing	罗汉卸兵
o an ie ing	罗汉卸兵
an ie ve	罗汉卸岳
o an ie ve	罗汉卸岳
an in an	千手百臂观音乱 观音乱 锻筋关
in an ing	观音乱影
an in an ing	观音乱影
in an II	观音乱世
an in an II	观音乱世
an ai	罗刹黄金战铠 观音乱脉
in an ai	罗刹黄金战铠 观音乱脉
an in an ai	观音乱脉
in o ie	观音火劫
an in o ie	观音火劫
i an in an	千手百臂观音乱
a ie	化劫 菩萨灭
u a ie	菩萨灭
a ie ing	菩萨灭顶
u a ie ing	菩萨灭顶
a ie ao	菩萨灭道
u a ie ao	菩萨灭道
u ai o	如来破
ai o i	如來破极
u ai o i	如來破极
a o ian	花火炼
in ian ian	焮天焰
ve o ing	血火鼎 黑绝魔经
ve o en ian	血火沉天
in en o	地心真火
i in en o	地心真火
ve v	熔沼血狱 穹苍血雨 阿鼻绝狱
ao ve v	熔沼血狱
ong ao ve v	熔沼血狱
ong ang an	火龙双转
o ong ang an	火龙双转
v ong u	炼狱烘炉
ian v ong u	炼狱烘炉
en o ou	炼狱真火球
v en o ou	炼狱真火球
an ie an	螺旋烈转
o an ie an	螺旋烈转
o o ian	真火托天
en o o ian	真火托天
o ei eng	地火围城
e o ei eng	地火围城
v o ou	冥狱火球
ing v o ou	冥狱火球
o ong ian an	火龙千转
ong u ao	天穹五道
ian ong u ao	天穹五道
II i i	冬日熙熙
ong II i i	冬日熙熙
eng u ing	南锋无定
an eng u ing	南锋无定
ian ou u	西天求渡
i ian ou u	西天求渡
ing ei ang	北冥飞伤
ei ing ei ang	北冥飞伤
i ei ong	四炁归宗
I i ei ong	四炁归宗
ie i ong	万劫一空
an ie i ong	万劫一空
en o ian ao	真魔天道
ie ao eng a	斩铁暴风杀
ie en ie	血魅邪魂劫
ei ie en ie	血魅邪魂劫
u a en	封神虎杀阵
en u a en	封神虎杀阵
eng en II	封神式
an u II	断虎式
u a ei	修罗怒杀腿
o u a ei	修罗怒杀腿
ang an en	魔狼战身
o ang an en	魔狼战身
II i	一以十里 伏虎之气 十阳之气 灭天之翼 降龙之气 降龙伏虎之气
ian II i	灭天之翼
ie ian II i	灭天之翼
a en ong	菩提证法神功 鄂家神功 金甲神功
e a en ong	鄂家神功
I an o	紫旋破
an I ian	紫旋撕天
I an I ian	紫旋撕天
I an o ve	紫旋破岳
an ong an an	紫旋龙卷缠
ao ao ian	天外逍遥篇
ai ao ao ian	天外逍遥篇
ou ian en	意守乾坤
i ou ian en	意守乾坤
II u ai	神驰物外
en II u ai	神驰物外
ao u i	天道无极 逍遥无极
ao ao u i	逍遥无极
ei en ong	罗刹魅神功
a ei en ong	罗刹魅神功
ang in an ai	罗刹黄金战铠
ie ie ve	三界灭绝
an ie ie ve	三界灭绝
er a	二霸
ei ing a	九霄雷霆霸
ao ei ing a	九霄雷霆霸
ong a	九幽冥空霸 真龙杀 雷霆冥空霸 龙甲 龙甲
ing ong a	九幽冥空霸 雷霆冥空霸
ou ing ong a	九幽冥空霸
ing ing ong a	雷霆冥空霸
ian ang ve	刀剑双绝 电光攫
ou ing an	流星贯
ing o ong	荧火轰 雷霆魔功 雷霆魔功
ie u ao	裂骨爆 邪无道 铁骨桥
ian u in	天无尽
ian i an	天地斩 青鉴秘卷
ing ian i an	青鉴秘卷
ing i ian	青气现
ing ian ai	青天开
ing ao ao	青涛啸
ing vn an	青云转
ian I II	闪电四式
an ian I II	闪电四式
an ing II	幻影式
ei ao II	围剿式
ao o II	爆破式
ong ang ong	铜像功
ao an an	铜炮穿山
ong ao an an	铜炮穿山
ong ao ian an	铜炮连环
a ong eng	铜马纵横
ong a ong eng	铜马纵横
i a ve	铜蹄踏雪
ong i a ve	铜蹄踏雪
ong ou ong	铜头功
u i ong	血雾迷踪 铁骨奇功
ie u i ong	铁骨奇功
ou in ong	铁手擒龙
ie ou in ong	铁手擒龙
ai ang ie	铁拐撞铁
ie ai ang ie	铁拐撞铁
an o ong	铁拳破空
ie an o ong	铁拳破空
an in ie ei	穿心铁锤
i ong eng	铁蹄纵横
ie i ong eng	铁蹄纵横
ao ong in	野豹冲林
ie ao ong in	野豹冲林
ao ong an	虎啸中原
u ao ong an	虎啸中原
e ang II II	恶狼噬日
ang ei an	熊掌推山
ong ang ei an	熊掌推山
ai ou ong ei	百兽同悲
ei ing o ong	雷霆魔功 雷霆魔功
ing ei o	惊雷破
ei ing i i	雷霆一击
ei en en u	雷神震怒
I i ou	紫气收
i o ie	气破界
o an ao	螺旋绞
u ian ve	诛天诀
u i ie	储电护体阶 天诛地灭
ian u i ie	储电护体阶 天诛地灭
ian ong e	冰天冻地
ing ian ong e	冰天冻地
en I II	杀神四式
a en I II	杀神四式
ou i an	天愁地惨
ian ou i an	天愁地惨
ing u an	生灵涂炭
eng ing u an	生灵涂炭
en v ie	万神俱灭
an en v ie	万神俱灭
i an ve	七残诀
u en v	身无寸缕
en u en v	身无寸缕
ing ie ou	庖丁解牛
ao ing ie ou	庖丁解牛
in o	分筋错 阴火
en in o	分筋错
ve ai ao	血在烧
ing o ei	吸精夺髓
i ing o ei	吸精夺髓
u u i	盘古五极
an u u i	盘古五极
ao ian ang ve	刀剑双绝
ian ang ong	一剑藏空
i ian ang ong	一剑藏空
ao ve ong	一刀绝空
i ao ve ong	一刀绝空
ian u ong	百剑无踪
ai ian u ong	百剑无踪
ao o i	十刀破极
II ao o i	十刀破极
an ian ei an	万剑归元
ao u in	千刀不尽
ian ao u in	千刀不尽
a o ang	杀破狼
ang a II	狼牙噬
ou ang u II	九狼逐日
an ang II II	贪狼噬日
ang ang an ian	狂狼斩天
ang ou ian	狂狼吼天
ang ang ou ian	狂狼吼天
a ve an	天残杀月斩
an a ve an	天残杀月斩
ang ang u ong	双狼出洞
eng an i II	锋寒七式
e eng	塞外戈声 舍生
ai e eng	塞外戈声
ai ai e eng	塞外戈声
ang ian I i	狼烟四起
u ai u	黄土埋骨
ang u ai u	黄土埋骨
a i in	热沙砾金
e a i in	热沙砾金
ai II en ou	海市蜃楼
ang ie ing ei	旷野惊雷
o eng ao	大漠风暴
a o eng ao	大漠风暴
eng a en ong	菩提证法神功
v eng vn	六道万行御风云
ing v eng vn	六道万行御风云
en ian en	观心千手震乾坤
ou en ian en	观心千手震乾坤
u ao o	神龙现爪诛妖魔
ao u ao o	神龙现爪诛妖魔
o v ong	冰锁虚空 冰锁虚空 破虚空 雷霆忿怒破虚空
u o v ong	雷霆忿怒破虚空
I u i	紫菩提 紫菩提
ai i u ang	四方如来气无量
ou ang en ong	九阳神功 九阳神功
en ang ong	正一纯阳功 烈火焚阳功 移形分阳功
ing en ang ong	移形分阳功
i i ang	二阳霹雳掌 霹雳象
ang i i ang	二阳霹雳掌
o ang an	幻影破阳拳
ing o ang an	幻影破阳拳
ie ang ei	百变烈阳腿
ian ie ang ei	百变烈阳腿
u u ang ao	五路阳爪
ai ang in	旋风太阳劲
eng ai ang in	旋风太阳劲
o en ang ong	烈火焚阳功
u an ang II	八步穿阳指
ie ang in	烈阳劲
ao ie an	五道邪元
u ao ie an	五道邪元
e o ong	千蛇破洞
ian e o ong	千蛇破洞
ang ian en	蛛网乾坤
u ang ian en	蛛网乾坤
ai u ong eng	百毒纵横
u ie an ao	五毒邪元爪
ie an a	千鬼邪元杀
ei ie an a	千鬼邪元杀
ou u ao	唐手武道
ang ou u ao	唐手武道
i u ing	天地无情
ian i u ing	天地无情
i en an ou	一本贯手
ong a i ou	观空大劈手
ao ao I ang	傲啸四方
ian i eng ing	千里横行
a an e	怒拔山河
u a an e	怒拔山河
ao an ei	寒刀断水
an ao an ei	寒刀断水
vn e ao	风云合招
eng vn e ao	风云合招
ian ao u i	天道无极
e u ang	功德无量 摩诃无量 舍无量
o e u ang	摩诃无量
ie ian ong	烈焰功 鬼劫仙功
ei ie ian ong	鬼劫仙功
II ei ou	万势归幽
an II ei ou	万势归幽
ou u ang	万寿无疆 千手无量
an ou u ang	万寿无疆
in en ei	无尽轮回
u in en ei	无尽轮回
a o ong	达摩功 黑煞魔功
ei a o ong	黑煞魔功
ian ei o an	天雷破山
ian ong ao	恶电冲霄
e ian ong ao	恶电冲霄
ei o ve	二雷破岳 五雷破岳
er ei o ve	二雷破岳
u ei o ve	五雷破岳
ei o v	惊雷魔雨
ing ei o v	惊雷魔雨
ang ei ang o	双雷荡魄
en an in	魍魉混元劲
ang en an in	魍魉混元劲
e ei o ing	第七重恶鬼索命
ei i ve	第八重厉鬼啼血
i ei i ve	第八重厉鬼啼血
ei u en ao	第十三重鬼哭神号
in ian an	天心莲环
ian in ian an	天心莲环
ang o in	包藏祸芯
ao ang o in	包藏祸芯
ian u ian	双莲吐艳
ang ian u ian	双莲吐艳
ai eng II	节外生枝
ie ai eng II	节外生枝
v ian ian	风雨莲天
eng v ian ian	风雨莲天
a ian o	借花献佛
ie a ian o	借花献佛
u ian an ian	无间串莲
II ou ang	万世流芳
an II ou ang	万世流芳
a e	破莲八着
ian a e	破莲八着
o ian a e	破莲八着
ing ong e	轻重着
a ao e	大小着
ang an e	方圆着
an u e	寒暑着 泥船渡河
ong ing e	动静着
eng e	纵横着
ong eng e	纵横着
ing an e	明暗着
v II e	虚实着
an eng ve	轮回转生诀
ei an eng ve	轮回转生诀
e an	地关 恶缠 星河斩 血洗河山
e ei	饿鬼
i v	地狱 恶电殛狱
ve en ing	血神经
i ang ang	血气方刚
ve i ang ang	血气方刚
e en ou	血河奔流
ve e en ou	血河奔流
v en ing	血聚神凝
ve v en ing	血聚神凝
i e an	血洗河山
ve i e an	血洗河山
an ang ong	血染长空
ve an ang ong	血染长空
eng ai	血压澎湃
a eng ai	血压澎湃
ve a eng ai	血压澎湃
ou ve	天下有血
a ou ve	天下有血
ian a ou ve	天下有血
ei an II	暴雷三式
ao ei an II	暴雷三式
v ing ei	暴雨惊雷
ao v ing ei	暴雨惊雷
ing i en	雷霆殛震
ei ing i en	雷霆殛震
ong en ve	暗空神诀
an ong en ve	暗空神诀
ang ang II	苍狼势
e u II	恶蝠势
ie ing II	夜鹰势
u ou o	冥府修罗
ing u ou o	冥府修罗
ao an en	六道战神
ou ao an en	六道战神
u ong ian	冰火五重天 冰火五重天
o u ong ian	冰火五重天 冰火五重天
o ong u ian	火龙初现 火龙初现
ong ong ao	冰龙冲霄 冰龙冲霄
ing ong ong ao	冰龙冲霄 冰龙冲霄
ian i ing	龙潜迷冰 龙潜迷冰
ong ian i ing	龙潜迷冰 龙潜迷冰
ong eng o an	龙腾火渊 龙腾火渊
ai an ong	冰海翻龙 冰海翻龙
ing ai an ong	冰海翻龙 冰海翻龙
ong ao II	焰龙抱日 焰龙抱日
ian ong ao II	焰龙抱日 焰龙抱日
ong eng ve	雪龙崩月 雪龙崩月
ve ong eng ve	雪龙崩月 雪龙崩月
ian v	火海炼狱 火焚炼狱 火焚炼狱 火轮炼狱
en ian v	火焚炼狱 火焚炼狱 火轮炼狱
o en ian v	火焚炼狱 火焚炼狱 火轮炼狱
ing o v ong	冰锁虚空 冰锁虚空
u ang in	四梵无量心
an u ang in	四梵无量心
I u ang	慈无量 慈无量
ian ou II	梵天救世
an ian ou II	梵天救世
u I ang	净土慈航
ing u I ang	净土慈航
ei u ang	悲无量
u ai u ian	苦海无边
e ian in	极乐仙音
i e ian in	极乐仙音
ian e i	刀剑合一 雷电合击
ao ian e i	刀剑合一
o ian ang	刀罗剑网 霍电象
ao o ian ang	刀罗剑网
ao an ian ve	刀渊剑岳
a ian ve	刀霸剑绝
ao a ian ve	刀霸剑绝
eng ang ve	圣王诀
— u ao	外王六艺——书道
i — u ao	外王六艺——书道
II ian ang an	指点江山
ou ong e	笔走龙蛇
i ou ong e	笔走龙蛇
ian ing II o	天惊石破
i vn u	风急云怒
eng i vn u	风急云怒
o I ang	傲啸风云我自王
vn o I ang	傲啸风云我自王
an en ing	楚庄王中原问鼎
ong an en ing	楚庄王中原问鼎
ao ing ong	剑傲英雄
ian ao ing ong	剑傲英雄
i an an	盛意拳拳
eng i an an	盛意拳拳
v i	—以念聚意 止约于礼 金缕衣
ve v i	止约于礼
II ve v i	止约于礼
ai i en ei	拜揖门楣
in v	射石饮羽
II in v	射石饮羽
e II in v	射石饮羽
an u ing in	战鼓鸣金
ang ao ao	刀章妙炒
ao ang ao ao	刀章妙炒
ang an ve	刀章三诀 双芒赶月
ao ang an ve	刀章三诀
eng en ie	横纹切
II ai an	直排斩
I a	妙炒四法
ao I a	妙炒四法
ao ao I a	妙炒四法
u ong ao	五龙道
ang ang ong	掌藏龙
an ong ie	蟠龙泄
ao ong o	蛟龙错
v ong ao	聚龙抱
en ong a	真龙杀
i ang en ian	逆阳神鉴
ei u en	五内如焚 五内如焚
u ei u en	五内如焚 五内如焚
ang an ang	光芒万丈
ang ang an ang	光芒万丈
ao u ian i	焦土千里
u ai en ian	煮海焚天
an ong ang	阳断穹苍
ang an ong ang	阳断穹苍
ai an i II	开山劈石
ian a i	上天下地
ang ian a i	上天下地
vn in ian a	君临天下
ao u ong	密宗黑教武功
ei ao u ong	密宗黑教武功
ong ong ao ou	密宗龙爪手
in ang in ong	金刚擒龙
ong in ang ang	密宗金刚掌
ong in ang ei	密宗金刚腿
ang an ong	金刚盘龙
in ang an ong	金刚盘龙
vn ie	扫荡群邪
ang vn ie	扫荡群邪
ao ang vn ie	扫荡群邪
ei ing i	连环魁星踢
an ei ing i	连环魁星踢
ong in ang an	密宗金刚拳
en en a	奇门遁甲
i en en a	奇门遁甲
an ei an	人关紫蓝内丹 烈旋水转
ie an ei an	烈旋水转
ian ou u ang	千手无量
II in ei	破日金锥
o II in ei	破日金锥
ing ong ve	五行轰岳
u ing ong ve	五行轰岳
ai ian o	开天破
i i ei	辟地碎
ing ing ve	惊灵绝
an II o	元始搏
ei ie ang	贝叶掌
a u II	法华渡世
a a u II	法华渡世
u I ai	大千世界佛自在
ie u I ai	大千世界佛自在
a ei ong	万法归宗
an a ei ong	万法归宗
ei ie ao	贝叶刀
I ang u u	慈航普渡
eng i e	早登极乐
ao eng i e	早登极乐
ao ang o	伏妖降魔
u ao ang o	伏妖降魔
i ai u II	力在布施
ong e u ang	功德无量
o en ve	火尊诀
i en ian	太极真焰
ai i en ian	太极真焰
ong ang ao ian	洪荒浩焰
vn ve	水云诀 白云诀 白云诀
ei vn ve	水云诀
i an u e	泥船渡河
in o ang	金鳞破浪
in in o ang	金鳞破浪
in ang ao	阴阳道
in ang o	阴阳错
ang en en	阴阳混沌
in ang en en	阴阳混沌
i vn an	两极循环
ang i vn an	两极循环
a II an ong	义和大日玄功
ian an an	吼天战拳
ou ian an an	吼天战拳
ian ie II	吼天灭世
ou ian ie II	吼天灭世
ao I ve	神鸟四绝
en ao I ve	神鸟四绝
ang ao ang	凤凰朝王
eng ang ao ang	凤凰朝王
en ian ao ian	浑天宝鉴
ie ing i	裂冰劈
eng ve an	崩雪斩
ing e an	星河斩
e i an	星河气旋
ing e i an	星河气旋
an ing e	回转星河
ei an ing e	回转星河
an en en	玄混沌
ian en II	茧困势
ang ian II	两茧势
ang ai	蓝苍海 靛沧海
ian ang ai	靛沧海
ao ian II	滔天势
en an II	深渊势
ao ang ao ian	朝阳耀天
in ian an vn	金剑穿云
ang ang an ve	双芒赶月
i ei ian	霹雳摧天
i i ei ian	霹雳摧天
i in an	无敌金环
u i in an	无敌金环
ang o v	金阳破狱
in ang o v	金阳破狱
II ang ei i	十阳归一
in ang o ing	金杨破岭
ang II i	十阳之气
II ang II i	十阳之气
an ve ang an	穿越光环
ve eng ei	日月争辉
II ve eng ei	日月争辉
ve ong ang	血穹苍
ang u a	穹苍无涯
ong ang u a	穹苍无涯
ve u i ong	血雾迷踪
ang I ian	血阳撕天
ve ang I ian	血阳撕天
ong ang u ian	穹苍无边
ang u ei	穹苍无悔
ong ang u ei	穹苍无悔
ang ve a	穹苍血甲
ong ang ve a	穹苍血甲
ang ve v	穹苍血雨
ong ang ve v	穹苍血雨
ang ing eng	穹苍腥风
ong ang ing eng	穹苍腥风
v ing ao	血雨晶刀
ve v ing ao	血雨晶刀
ve ei ong ang	血归穹苍
ve ai u a	血海无涯
u ing ian	冰柱擎天
ing u ing ian	冰柱擎天
eng i ong ang	血雨腥風洗穹苍
v ou	玄宇宙 紫宇宙
an v ou	玄宇宙
a ao a	大爆炸
ian ing ian	天行健
u ei en	前九式逆转反扑归真
an u ei en	前九式逆转反扑归真
ing an in	冰玄劲
eng II ang	冰封十丈 冰封十丈
ing eng II ang	冰封十丈 冰封十丈
an I u	冰寒刺骨 冰寒刺骨
ing an I u	冰寒刺骨 冰寒刺骨
a an an	冰剐万斩 冰剐万斩
ing a an an	冰剐万斩 冰剐万斩
ing e ang ang	冰河莽莽 冰河莽莽
an eng en	冰玄成盾 冰玄成盾
ing an eng en	冰玄成盾 冰玄成盾
II ong	九阴寒尸功 冰玄冻时空 冰玄冻时空
ong II ong	冰玄冻时空 冰玄冻时空
an ong II ong	冰玄冻时空 冰玄冻时空
o i in in	冰魄麒麟劲
in u II	狂麟扑噬
ang in u II	狂麟扑噬
in ong ie	麒麟冻结
i in ong ie	麒麟冻结
an ve eng	冰山雪崩
ing an ve eng	冰山雪崩
ang eng ve	长生诀 长生诀
ie o in	长生烈火劲
eng ie o in	长生烈火劲
an ing in	长生寒冰劲
eng an ing in	长生寒冰劲
o an in	两极冰火螺旋劲 混沌螺旋劲 长生冰火螺旋劲 长生寒冰螺旋劲 长生寒冰螺旋劲 长生寒冰螺旋劲 长生烈火螺旋劲 长生烈火螺旋劲 长生烈火螺旋劲
o o an in	两极冰火螺旋劲 长生冰火螺旋劲 长生烈火螺旋劲 长生烈火螺旋劲 长生烈火螺旋劲
ing o an in	长生寒冰螺旋劲 长生寒冰螺旋劲 长生寒冰螺旋劲
en o an in	混沌螺旋劲
i i eng	和氏璧异能 和氏璧异能 和氏璧异能 和氏璧异能 和氏璧异能
II i i eng	和氏璧异能 和氏璧异能 和氏璧异能 和氏璧异能 和氏璧异能
i an i ong	三一元气功
ve en i	长生诀真气
eng ve en i	长生诀真气
i e i	两极归元天地合一 圣帝舍利
eng i e i	圣帝舍利
en in en i	先天纯阴真气
ang en i	先天纯阳真气
en ang en i	先天纯阳真气
eng u ie	长生不灭
ang eng u ie	长生不灭
an en i	五星战神气
ing an en i	五星战神气
o ing an i	火星战气
ei ing an i	水星战气
in ing an i	金星战气
i II en ong	上天下地至尊功
ing u e	天罡气诀之五行互克
u ing u e	天罡气诀之五行互克
in an u	无尽乱舞
u in an u	无尽乱舞
ang an ang i	地霸气诀之阴阳玄刚气
in an i	至尊功之纯阴玄气
en in an i	至尊功之纯阴玄气
ang ang i	烈阳刚气
ie ang ang i	烈阳刚气
ang ian ing ie	无尚天境界
ei ve o ing	黑绝魔经
ang I	忘死
an ing ong	玄冰功 离火玄冰功
o an ing ong	离火玄冰功
i o ong	离火功
o e ong	龙象般若功
ang o e ong	龙象般若功
o ei an ong	三火归元功
ian en ong	火焰神功
o ian en ong	火焰神功
o o ing	婆罗魔经
o o o ing	婆罗魔经
ve i an	绝息关
ian u an	炼骨关
ang i ong ian	魔光七重天
ang an en ei	魔光绽春雷
ang ing e u	魔光惊蛰伏
ang a u	魔光阳大暑
ang ang a u	魔光阳大暑
ve u i	魔光月无极
ang ve u i	魔光月无极
II u i	魔光日无极
ang II u i	魔光日无极
o i ong ian	冰火七重天
ao ian ang i	昊天罡气
II an a ing	十全霸境
ong en ong	密宗神功
i ong en ong	密宗神功
a II en in	大日轮印
en ou in	大金刚轮手印
ang en ou in	大金刚轮手印
en ei in	五世轮回印 五世轮回印
II en ei in	五世轮回印 五世轮回印
u II en ei	五世轮回
ai ei an	二脉归元
er ai ei an	二脉归元
er ang i	七十二罡气 九转七十二罡气 四转三十二罡气
II er ang i	七十二罡气 九转七十二罡气 四转三十二罡气
an a ang i	一转八罡气
ou ang i	七转五十六罡气 二转十六罡气
II ou ang i	七转五十六罡气 二转十六罡气
I ang i	三转二十四罡气 八转六十四罡气
II I ang i	三转二十四罡气 八转六十四罡气
II ang i	五转四十罡气
I II ang i	五转四十罡气
II a ang i	六转四十八罡气
ong I ong	童子功
ong in ve	童心诀 童心诀
ai vn ve	白云诀 白云诀
ou ing ve	流星诀 流星诀
ing ve ve	明月诀 明月诀
ong II ve	红日诀 红日诀
I in en	童子金身 童子金身
ong I in en	童子金身 童子金身
II ang en ong	狮王神功
an ian i ong	闪电奇功
ang en ie	发电伤人阶
ian ang en ie	发电伤人阶
ou o ong	凶兽魔功
ong ou o ong	凶兽魔功
en e ve	长恨歌诀
ang en e ve	长恨歌诀
u ing vn	紫宫高处入青云
u u ing vn	紫宫高处入青云
u u ing	仙气风飙处处行
ao u u ing	仙气风飙处处行
ve an ao eng	九重阙三焦生
ong ong in	千乘万骑汹涌临
i ong ong in	千乘万骑汹涌临
ian v i	—以念聚意
i ian v i	—以念聚意
i o i	以意驳气
i i o i	以意驳气
i an II	一以贯之
i i an II	一以贯之
ian ei II	悉所不能。一念沛之
i ian ei II	悉所不能。一念沛之
a en II	一刹神之
i a en II	一刹神之
i II i	一以十里
i i II i	一以十里
II ing ei	贯之惊雷
an II ing ei	贯之惊雷
ing ie ong	阎王令邪功
ang ing ie ong	阎王令邪功
ei a ie ong	鬼打邪功
e ang ei ang	地藏鬼王
eng en ong	大梦神功
a eng en ong	大梦神功
ie eng	解梦
i an ong	霹雳玄功
i i an ong	霹雳玄功
i eng en	霹雳猛震
i i eng en	霹雳猛震
i ang ian	霹雳狂电
i i ang ian	霹雳狂电
i ao ei	霹雳暴雷
i i ao ei	霹雳暴雷
in a en ong	金甲神功
an ai ian	山海篇
an ang ian	元阳篇
ing an v	雷霆战躯
ei ing an v	雷霆战躯
a i ong	天地煞气功 酩酊心法七重
i a i ong	天地煞气功
e a ian	地煞篇
ian a ian	天煞篇
ian i e i	两极归元天地合一
e en ong	般若神功
o e en ong	般若神功
v u i	绿菩提
ie o ie	烈火劫
o ai u a	火海无涯
ao o ie	暴火劫
an i en ong	万里焚空
ei o ie	鬼火劫
en o ie	神火劫
ang i ong	炎阳奇功
ian ang i ong	炎阳奇功
ai o en ian	太火焚天
ie ong in	煮铁融金
u ie ong in	煮铁融金
an ao ang	火伞高张
o an ao ang	火伞高张
ao ang i ao	骄阳熠耀
ve eng ian	银月圣典 银月圣典
in ve eng ian	银月圣典 银月圣典
ie ang en ong	烈阳神功 烈阳神功
I ie ong	九死邪功 九死邪功 九死邪功
ou I ie ong	九死邪功 九死邪功 九死邪功
an o v	刀山火狱
ao an o v	刀山火狱
ai ian v	火海炼狱
o ai ian v	火海炼狱
ing v	绝寒冰狱
an ing v	绝寒冰狱
ve an ing v	绝寒冰狱
II an v	疯噬幻狱
eng II an v	疯噬幻狱
ei ao v	阴雷暴狱
in ei ao v	阴雷暴狱
ian i v	恶电殛狱
e ian i v	恶电殛狱
ei v	化骨魅狱
u ei v	化骨魅狱
a u ei v	化骨魅狱
en o v	离魂魔狱
i en o v	离魂魔狱
i ve v	阿鼻绝狱
a i ve v	阿鼻绝狱
ai e ao	奈何道 奈何道
ei eng ao	回生道 回生道
i u ao	剔骨道 剔骨道
ei en ao	鬼门道 鬼门道
ing eng ao	冥生道 冥生道
an u ao	梵炉道 梵炉道
ian an eng	无间转生
u ian an eng	无间转生
an a a	九玄大法 金禅袈裟 金禅袈裟
ou an a a	九玄大法
ang in an ve	第一阳心坎穴
ang an ian ve	第二阳丹田穴
ei ing ve	第三阳足阳明胃经穴
ing ei ing ve	第三阳足阳明胃经穴
ang ing ve	第五阳手太阳小肠经穴 第四阳足太阳膀胱经穴
ang ang ing ve	第四阳足太阳膀胱经穴
ao ang ing ve	第五阳手太阳小肠经穴
ao ing ve	第六阳手少阳三焦经穴
an ao ing ve	第六阳手少阳三焦经穴
i ang ve	第七阳脊梁穴
ang i ang ve	第七阳脊梁穴
II ang ve	第八阳至阳穴
ang II ang ve	第八阳至阳穴
ai ei ve	第九阳百会穴
ang ai ei ve	第九阳百会穴
ou ang i ai	九阳启泰
ou ang u ao	九阳普照
ou ang ei i	九阳归一
in en ing	九阴真经
ou in en ing	九阴真经
in ei an	九阴归元
ou in ei an	九阴归元
an II ong	九阴寒尸功
in an II ong	九阴寒尸功
in i ve	九阴遗诀
ou in i ve	九阴遗诀
ao en ing	九霄真经 九霄真经 九霄真经
ou ao en ing	九霄真经 九霄真经 九霄真经
u en ang	雾雰象
v in ang	雨霖象
ve ao ang	雪雹象
a ong ang	霸靇象
v in	雨霖
ei a a	九死轮回大法
en ei a a	九死轮回大法
ou ei ang	饿兽鬼王
e ou ei ang	饿兽鬼王
i ei ang	瘟疫鬼王
en i ei ang	瘟疫鬼王
in ang ei ang	阴阳鬼王
ian ang ei ang	电光鬼王
ong ei ang	百虫鬼王
ai ong ei ang	百虫鬼王
ian ei ang	千眼鬼王
ian ian ei ang	千眼鬼王
o ei ang	森罗鬼王
en o ei ang	森罗鬼王
ie ei ang	无界鬼王
u ie ei ang	无界鬼王
e II en	万恶世尊
an e II en	万恶世尊
i ing i ong	九幽逆经奇功
ou ie en ei	九劫轮回
i in ing	易筋经
ong i u u	红级浮屠 红级浮屠
ang i u u	黄级浮屠 黄级浮屠
an i u u	蓝级浮屠 蓝级浮屠
ai i u u	白级浮屠 白级浮屠
ei i u u	黑级浮屠 黑级浮屠
ie ing ie	中阶境界 初阶境界 高阶境界
u ie ing ie	初阶境界
ong ie ing ie	中阶境界
ao ie ing ie	高阶境界
ing i u u	青级浮屠
I i u u	紫级浮屠
in ong ao	金钟罩
ie u an	铁布衫 铁布衫
i ie u	铜皮铁骨
ong i ie u	铜皮铁骨
ai an a	铁铠战甲
ie ai an a	铁铠战甲
vn ing	将军令
ang vn ing	将军令
ong ai a	铜铠甲
in an ao	银战袍
in v i	金缕衣
i a ao	混元无极大道
u i a ao	混元无极大道
I ang ong	赤盖四阳功
ai I ang ong	赤盖四阳功
o ing ang ong	火精当空
in o u ao	金锣普照
i en an ian	曦轮万千
ai en eng	赤盖焚城
II ai en eng	赤盖焚城
an o I ian	幻魔四变
eng ang en ang	凤皇神罡
o eng ao an	火凤燎原
i ian ang	火翼天翔
o i ian ang	火翼天翔
II ei ang	振翅飞扬
en II ei ang	振翅飞扬
eng ie an	火凤涅磐
o eng ie an	火凤涅磐
eng ing ao ang	凤鸣朝阳
o eng an u	火凤乱舞
an ai eng	涅磐再生
ie an ai eng	涅磐再生
ou ong ian	凤吼冲天
eng ou ong ian	凤吼冲天
eng ang II	不灭凤凰势
ie eng ang II	不灭凤凰势
eng ang an	不灭凤凰断
ie eng ang an	不灭凤凰断
i in a	两极心法
ang i in a	两极心法
an ang ai	蓝苍海
in ong ang	金穹苍
I v ou	紫宇宙
an ing ian ve	轩辕惊天诀
ian i en	盘古天殛震
u ian i en	盘古天殛震
en ian u	伏羲问天录
i en ian u	伏羲问天录
an ang en ong	轩辕三罡神功
eng ang in	风罡劲
ei ang in	雷罡劲
ian ang in	电罡劲
ei an in	归元劲
u II i	伏虎之气 降龙伏虎之气
u u II i	伏虎之气 降龙伏虎之气
ong II i	降龙之气
ang ong II i	降龙之气
ong u in	霹雳龙虎劲
i ong u in	霹雳龙虎劲
i ian ing	如意天经
u i ian ing	如意天经
i ai u a	气海无涯
i i ai	地极气海 天极气海
ian i i ai	天极气海
i i i ai	地极气海
II I i	大日紫气
a II I i	大日紫气
o ian en	电锁乾坤
ian o ian en	电锁乾坤
i ong ai	紫气东来
I i ong ai	紫气东来
I a in	紫煞劲
ai ong ang	气盖穹苍
i ai ong ang	气盖穹苍
I i ei an	紫气归元
ei ian e i	雷电合击
ian ing ei	暴电惊雷
ao ian ing ei	暴电惊雷
in a i ong	酩酊心法七重
a ei i en	醉一分——大醉七分
o i a a	天魔秘大法
o en en	天魔分身
ian o en en	天魔分身
ian o u	天魔舞
ian o ang	大天魔场 小天魔场
ao ian o ang	小天魔场
a ian o ang	大天魔场
o ie i	天魔解体
ian o ie i	天魔解体
II v en	玉石俱焚
v II v en	玉石俱焚
ing in ve	冰心诀
ing ing	心若冰清
o ing ing	心若冰清
in o ing ing	心若冰清
a u ing	天塌不惊
ian a u ing	天塌不惊
ian ou ing	万变犹定
an ian ou ing	万变犹定
i i ing	神怡气静
en i i ing	神怡气静
ong ing i	虚空甯宓
v ong ing i	虚空甯宓
en an u u	浑然无物
u ou ang eng	无有相生
i ang eng	难以相成
an i ang eng	难以相成
v u ang	份与物忘
en v u ang	份与物忘
u en ie	同乎混涅
ong u en ie	同乎混涅
i u a	天地无涯
ian i u a	天地无涯
u i i	万物齐一
an u i i	万物齐一
a o ie	飞花落叶
ei a o ie	飞花落叶
v ai o u	虚怀若谷
an an ou	千般烦忧 千般烦忧
ian an an ou	千般烦忧 千般烦忧
ai a in ou	才下心头 才下心头
an ei ou	即展眉头 即展眉头
i an ei ou	即展眉头 即展眉头
ai ing ou	灵台清幽 灵台清幽
ing ai ing ou	灵台清幽 灵台清幽
a ai	心无挂碍
u a ai	心无挂碍
in u a ai	心无挂碍
i u o II	意无所执
in II en	解心释神
ie in II en	解心释神
an u en	莫然无魂
o an u en	莫然无魂
in u ing	水流心不惊
ou in u ing	水流心不惊
v II	云在意具迟
i v II	云在意具迟
ai i v II	云在意具迟
u ei u	一心不赘物
in u ei u	一心不赘物
I ao ao	古今自逍遥
in I ao ao	古今自逍遥
i en ang ong	正一纯阳功
v ang i	旭阳级
eng eng ve	乘风诀
ai i eng	太极封
ang i ian	两仪剑
ie ang i	烈阳级
ian an u	天蚕缚
an ing ie	玄冰结
ai an eng	泰山崩
en ang i	纯阳级
en ang ang	纯阳掌
I ing ian	四灵剑
II i ing	阳世奇经 阴世奇经 阴世奇经
in II i ing	阴世奇经 阴世奇经
ve en ian	日月神鉴 日月神鉴
II ve en ian	日月神鉴 日月神鉴
ang II i ing	阳世奇经
ian i a a	天地大法 天地大法
ang a a	阴阳大法
in ang a a	阴阳大法
en a a	乾坤大法
ian en a a	乾坤大法
o en eng a	一倍涡轮增压 三倍涡轮增压 两倍涡轮增压 四倍涡轮增压
ian o in	奇门阎罗劲
en ian o in	奇门阎罗劲
a ang en ong	霸王神功
an ie e	无环裂地
u an ie e	无环裂地
u I ian	无柱撕天
u u I ian	无柱撕天
en u o	无恨无我
u en u o	无恨无我
en ai ve	神脉诀
II er	经脉十二
ai II er	经脉十二
ing ai II er	经脉十二
ai II u	络脉十五
o ai II u	络脉十五
in ao ian	玄阴宝鉴
an in ao ian	玄阴宝鉴
ian en ing	魔典真经
o ian en ing	魔典真经
I an ei an	人关紫蓝内丹
i v ei an	地关碧绿内丹
II ong ei an	天关赤红内丹
er a a	梵我不二大法
u er a a	梵我不二大法
ian an en	小梵天禅震
an ian an en	小梵天禅震
ian en an	大梵天震禅
an ian en an	大梵天震禅
e in a	配合心法
ei e in a	配合心法
an o u i	梵我如一
v e i	井中月&遁去的一
en v e i	井中月&遁去的一
en e ei ong	配合任何内功
ai in en	不坏金身
u ai in en	不坏金身
i ai a	琉璃铠甲 舍利铠甲
ou i ai a	琉璃铠甲
ei ai a	惊雷铠甲
ing ei ai a	惊雷铠甲
e i ai a	舍利铠甲
ao u ang ong	小无相功
a u ang ong	大无相功
a u ong	甲骨功
in an a a	金禅袈裟 金禅袈裟
ou o a	骷髅魔甲 骷髅魔甲
u ou o a	骷髅魔甲 骷髅魔甲
u ing i	五行气
ing en ong	逍遥令神功
ao ing en ong	逍遥令神功
